,count_amphibians,count_reptiles,count_mammals,Total,geometry,lon,lat
0,16,16,99,131,POINT (-85.90579343002176 10.900731980985938),-85.90579343002176,10.900731980985938
1,16,50,100,166,POINT (-85.86986143002176 10.900731980985938),-85.86986143002176,10.900731980985938
2,15,15,98,128,POINT (-85.86986143002176 10.944595980985937),-85.86986143002176,10.944595980985937
3,16,48,101,165,POINT (-85.83392943002175 10.856867980985939),-85.83392943002175,10.856867980985939
4,16,48,100,164,POINT (-85.83392943002175 10.900731980985938),-85.83392943002175,10.900731980985938
5,0,6,26,32,POINT (-85.83392943002175 10.944595980985937),-85.83392943002175,10.944595980985937
6,16,43,101,160,POINT (-85.79799743002175 10.856867980985939),-85.79799743002175,10.856867980985939
7,16,48,100,164,POINT (-85.79799743002175 10.900731980985938),-85.79799743002175,10.900731980985938
8,0,6,26,32,POINT (-85.79799743002175 10.944595980985937),-85.79799743002175,10.944595980985937
9,0,6,26,32,POINT (-85.79799743002175 10.988459980985937),-85.79799743002175,10.988459980985937
10,17,35,99,151,POINT (-85.76206543002175 10.111179980985952),-85.76206543002175,10.111179980985952
11,17,34,99,150,POINT (-85.76206543002175 10.155043980985951),-85.76206543002175,10.155043980985951
12,17,34,99,150,POINT (-85.76206543002175 10.19890798098595),-85.76206543002175,10.19890798098595
13,17,35,99,151,POINT (-85.76206543002175 10.24277198098595),-85.76206543002175,10.24277198098595
14,17,35,98,150,POINT (-85.76206543002175 10.286635980985949),-85.76206543002175,10.286635980985949
15,17,35,98,150,POINT (-85.76206543002175 10.330499980985948),-85.76206543002175,10.330499980985948
16,17,35,98,150,POINT (-85.76206543002175 10.374363980985947),-85.76206543002175,10.374363980985947
17,17,37,98,152,POINT (-85.76206543002175 10.418227980985947),-85.76206543002175,10.418227980985947
18,17,13,98,128,POINT (-85.76206543002175 10.462091980985946),-85.76206543002175,10.462091980985946
19,17,15,95,127,POINT (-85.76206543002175 10.505955980985945),-85.76206543002175,10.505955980985945
20,16,13,101,130,POINT (-85.76206543002175 10.81300398098594),-85.76206543002175,10.81300398098594
21,16,46,101,163,POINT (-85.76206543002175 10.856867980985939),-85.76206543002175,10.856867980985939
22,16,48,101,165,POINT (-85.76206543002175 10.900731980985938),-85.76206543002175,10.900731980985938
23,0,7,26,33,POINT (-85.76206543002175 10.944595980985937),-85.76206543002175,10.944595980985937
24,0,6,26,32,POINT (-85.76206543002175 10.988459980985937),-85.76206543002175,10.988459980985937
25,0,6,26,32,POINT (-85.76206543002175 11.032323980985936),-85.76206543002175,11.032323980985936
26,17,33,99,149,POINT (-85.72613343002175 10.067315980985953),-85.72613343002175,10.067315980985953
27,17,33,99,149,POINT (-85.72613343002175 10.111179980985952),-85.72613343002175,10.111179980985952
28,17,33,99,149,POINT (-85.72613343002175 10.155043980985951),-85.72613343002175,10.155043980985951
29,17,33,99,149,POINT (-85.72613343002175 10.19890798098595),-85.72613343002175,10.19890798098595
30,17,34,99,150,POINT (-85.72613343002175 10.24277198098595),-85.72613343002175,10.24277198098595
31,17,34,98,149,POINT (-85.72613343002175 10.286635980985949),-85.72613343002175,10.286635980985949
32,17,34,98,149,POINT (-85.72613343002175 10.330499980985948),-85.72613343002175,10.330499980985948
33,17,34,98,149,POINT (-85.72613343002175 10.374363980985947),-85.72613343002175,10.374363980985947
34,17,37,98,152,POINT (-85.72613343002175 10.418227980985947),-85.72613343002175,10.418227980985947
35,17,37,98,152,POINT (-85.72613343002175 10.462091980985946),-85.72613343002175,10.462091980985946
36,17,13,97,127,POINT (-85.72613343002175 10.505955980985945),-85.72613343002175,10.505955980985945
37,0,7,26,33,POINT (-85.72613343002175 10.549819980985944),-85.72613343002175,10.549819980985944
38,0,6,26,32,POINT (-85.72613343002175 10.593683980985944),-85.72613343002175,10.593683980985944
39,16,25,102,143,POINT (-85.72613343002175 10.81300398098594),-85.72613343002175,10.81300398098594
40,16,47,102,165,POINT (-85.72613343002175 10.856867980985939),-85.72613343002175,10.856867980985939
41,16,49,103,168,POINT (-85.72613343002175 10.900731980985938),-85.72613343002175,10.900731980985938
42,0,7,26,33,POINT (-85.72613343002175 10.944595980985937),-85.72613343002175,10.944595980985937
43,0,6,26,32,POINT (-85.72613343002175 10.988459980985937),-85.72613343002175,10.988459980985937
44,15,16,110,141,POINT (-85.72613343002175 11.032323980985936),-85.72613343002175,11.032323980985936
45,0,7,26,33,POINT (-85.72613343002175 11.076187980985935),-85.72613343002175,11.076187980985935
46,17,32,88,137,POINT (-85.69020143002174 9.979587980985954),-85.69020143002174,9.979587980985954
47,17,34,99,150,POINT (-85.69020143002174 10.023451980985953),-85.69020143002174,10.023451980985953
48,17,33,100,150,POINT (-85.69020143002174 10.067315980985953),-85.69020143002174,10.067315980985953
49,17,33,100,150,POINT (-85.69020143002174 10.111179980985952),-85.69020143002174,10.111179980985952
50,17,33,100,150,POINT (-85.69020143002174 10.155043980985951),-85.69020143002174,10.155043980985951
51,17,33,100,150,POINT (-85.69020143002174 10.19890798098595),-85.69020143002174,10.19890798098595
52,17,34,101,152,POINT (-85.69020143002174 10.24277198098595),-85.69020143002174,10.24277198098595
53,17,34,100,151,POINT (-85.69020143002174 10.286635980985949),-85.69020143002174,10.286635980985949
54,17,34,100,151,POINT (-85.69020143002174 10.330499980985948),-85.69020143002174,10.330499980985948
55,17,35,99,151,POINT (-85.69020143002174 10.374363980985947),-85.69020143002174,10.374363980985947
56,17,36,99,152,POINT (-85.69020143002174 10.418227980985947),-85.69020143002174,10.418227980985947
57,17,39,99,155,POINT (-85.69020143002174 10.462091980985946),-85.69020143002174,10.462091980985946
58,17,40,99,156,POINT (-85.69020143002174 10.505955980985945),-85.69020143002174,10.505955980985945
59,17,14,98,129,POINT (-85.69020143002174 10.549819980985944),-85.69020143002174,10.549819980985944
60,0,7,26,33,POINT (-85.69020143002174 10.593683980985944),-85.69020143002174,10.593683980985944
61,0,6,26,32,POINT (-85.69020143002174 10.637547980985943),-85.69020143002174,10.637547980985943
62,16,49,103,168,POINT (-85.69020143002174 10.81300398098594),-85.69020143002174,10.81300398098594
63,16,49,104,169,POINT (-85.69020143002174 10.856867980985939),-85.69020143002174,10.856867980985939
64,16,48,106,170,POINT (-85.69020143002174 10.900731980985938),-85.69020143002174,10.900731980985938
65,16,51,108,175,POINT (-85.69020143002174 10.944595980985937),-85.69020143002174,10.944595980985937
66,15,15,108,138,POINT (-85.69020143002174 10.988459980985937),-85.69020143002174,10.988459980985937
67,0,5,26,31,POINT (-85.69020143002174 11.032323980985936),-85.69020143002174,11.032323980985936
68,15,47,100,162,POINT (-85.69020143002174 11.076187980985935),-85.69020143002174,11.076187980985935
69,17,33,99,149,POINT (-85.65426943002174 9.935723980985955),-85.65426943002174,9.935723980985955
70,17,34,99,150,POINT (-85.65426943002174 9.979587980985954),-85.65426943002174,9.979587980985954
71,17,33,99,149,POINT (-85.65426943002174 10.023451980985953),-85.65426943002174,10.023451980985953
72,17,33,100,150,POINT (-85.65426943002174 10.067315980985953),-85.65426943002174,10.067315980985953
73,17,34,100,151,POINT (-85.65426943002174 10.111179980985952),-85.65426943002174,10.111179980985952
74,17,33,100,150,POINT (-85.65426943002174 10.155043980985951),-85.65426943002174,10.155043980985951
75,17,33,101,151,POINT (-85.65426943002174 10.19890798098595),-85.65426943002174,10.19890798098595
76,17,34,101,152,POINT (-85.65426943002174 10.24277198098595),-85.65426943002174,10.24277198098595
77,17,34,100,151,POINT (-85.65426943002174 10.286635980985949),-85.65426943002174,10.286635980985949
78,17,34,100,151,POINT (-85.65426943002174 10.330499980985948),-85.65426943002174,10.330499980985948
79,17,37,100,154,POINT (-85.65426943002174 10.374363980985947),-85.65426943002174,10.374363980985947
80,17,38,99,154,POINT (-85.65426943002174 10.418227980985947),-85.65426943002174,10.418227980985947
81,17,39,99,155,POINT (-85.65426943002174 10.462091980985946),-85.65426943002174,10.462091980985946
82,17,41,100,158,POINT (-85.65426943002174 10.505955980985945),-85.65426943002174,10.505955980985945
83,17,41,100,158,POINT (-85.65426943002174 10.549819980985944),-85.65426943002174,10.549819980985944
84,0,6,26,32,POINT (-85.65426943002174 10.593683980985944),-85.65426943002174,10.593683980985944
85,0,7,26,33,POINT (-85.65426943002174 10.637547980985943),-85.65426943002174,10.637547980985943
86,17,10,90,117,POINT (-85.65426943002174 10.681411980985942),-85.65426943002174,10.681411980985942
87,17,49,103,169,POINT (-85.65426943002174 10.725275980985941),-85.65426943002174,10.725275980985941
88,18,49,104,171,POINT (-85.65426943002174 10.76913998098594),-85.65426943002174,10.76913998098594
89,17,51,104,172,POINT (-85.65426943002174 10.81300398098594),-85.65426943002174,10.81300398098594
90,16,51,105,172,POINT (-85.65426943002174 10.856867980985939),-85.65426943002174,10.856867980985939
91,16,51,107,174,POINT (-85.65426943002174 10.900731980985938),-85.65426943002174,10.900731980985938
92,16,54,109,179,POINT (-85.65426943002174 10.944595980985937),-85.65426943002174,10.944595980985937
93,16,53,111,180,POINT (-85.65426943002174 10.988459980985937),-85.65426943002174,10.988459980985937
94,15,52,113,180,POINT (-85.65426943002174 11.032323980985936),-85.65426943002174,11.032323980985936
95,15,53,112,180,POINT (-85.65426943002174 11.076187980985935),-85.65426943002174,11.076187980985935
96,16,53,113,182,POINT (-85.65426943002174 11.120051980985934),-85.65426943002174,11.120051980985934
97,17,33,99,149,POINT (-85.61833743002174 9.935723980985955),-85.61833743002174,9.935723980985955
98,17,32,99,148,POINT (-85.61833743002174 9.979587980985954),-85.61833743002174,9.979587980985954
99,17,33,100,150,POINT (-85.61833743002174 10.023451980985953),-85.61833743002174,10.023451980985953
100,17,33,100,150,POINT (-85.61833743002174 10.067315980985953),-85.61833743002174,10.067315980985953
101,17,34,101,152,POINT (-85.61833743002174 10.111179980985952),-85.61833743002174,10.111179980985952
102,17,33,102,152,POINT (-85.61833743002174 10.155043980985951),-85.61833743002174,10.155043980985951
103,17,32,102,151,POINT (-85.61833743002174 10.19890798098595),-85.61833743002174,10.19890798098595
104,17,34,101,152,POINT (-85.61833743002174 10.24277198098595),-85.61833743002174,10.24277198098595
105,17,34,100,151,POINT (-85.61833743002174 10.286635980985949),-85.61833743002174,10.286635980985949
106,17,35,100,152,POINT (-85.61833743002174 10.330499980985948),-85.61833743002174,10.330499980985948
107,17,37,100,154,POINT (-85.61833743002174 10.374363980985947),-85.61833743002174,10.374363980985947
108,17,39,100,156,POINT (-85.61833743002174 10.418227980985947),-85.61833743002174,10.418227980985947
109,17,40,100,157,POINT (-85.61833743002174 10.462091980985946),-85.61833743002174,10.462091980985946
110,17,41,100,158,POINT (-85.61833743002174 10.505955980985945),-85.61833743002174,10.505955980985945
111,17,42,100,159,POINT (-85.61833743002174 10.549819980985944),-85.61833743002174,10.549819980985944
112,17,43,101,161,POINT (-85.61833743002174 10.593683980985944),-85.61833743002174,10.593683980985944
113,17,46,103,166,POINT (-85.61833743002174 10.637547980985943),-85.61833743002174,10.637547980985943
114,17,49,104,170,POINT (-85.61833743002174 10.681411980985942),-85.61833743002174,10.681411980985942
115,17,51,104,172,POINT (-85.61833743002174 10.725275980985941),-85.61833743002174,10.725275980985941
116,18,52,105,175,POINT (-85.61833743002174 10.76913998098594),-85.61833743002174,10.76913998098594
117,19,52,107,178,POINT (-85.61833743002174 10.81300398098594),-85.61833743002174,10.81300398098594
118,17,52,108,177,POINT (-85.61833743002174 10.856867980985939),-85.61833743002174,10.856867980985939
119,16,53,109,178,POINT (-85.61833743002174 10.900731980985938),-85.61833743002174,10.900731980985938
120,16,53,110,179,POINT (-85.61833743002174 10.944595980985937),-85.61833743002174,10.944595980985937
121,16,52,111,179,POINT (-85.61833743002174 10.988459980985937),-85.61833743002174,10.988459980985937
122,16,51,113,180,POINT (-85.61833743002174 11.032323980985936),-85.61833743002174,11.032323980985936
123,15,52,112,179,POINT (-85.61833743002174 11.076187980985935),-85.61833743002174,11.076187980985935
124,15,51,114,180,POINT (-85.61833743002174 11.120051980985934),-85.61833743002174,11.120051980985934
125,16,51,114,181,POINT (-85.61833743002174 11.163915980985934),-85.61833743002174,11.163915980985934
126,17,32,99,148,POINT (-85.58240543002174 9.935723980985955),-85.58240543002174,9.935723980985955
127,17,32,100,149,POINT (-85.58240543002174 9.979587980985954),-85.58240543002174,9.979587980985954
128,17,33,100,150,POINT (-85.58240543002174 10.023451980985953),-85.58240543002174,10.023451980985953
129,17,34,100,151,POINT (-85.58240543002174 10.067315980985953),-85.58240543002174,10.067315980985953
130,17,33,101,151,POINT (-85.58240543002174 10.111179980985952),-85.58240543002174,10.111179980985952
131,17,33,102,152,POINT (-85.58240543002174 10.155043980985951),-85.58240543002174,10.155043980985951
132,17,32,102,151,POINT (-85.58240543002174 10.19890798098595),-85.58240543002174,10.19890798098595
133,17,33,101,151,POINT (-85.58240543002174 10.24277198098595),-85.58240543002174,10.24277198098595
134,17,34,100,151,POINT (-85.58240543002174 10.286635980985949),-85.58240543002174,10.286635980985949
135,17,35,100,152,POINT (-85.58240543002174 10.330499980985948),-85.58240543002174,10.330499980985948
136,17,39,100,156,POINT (-85.58240543002174 10.374363980985947),-85.58240543002174,10.374363980985947
137,17,39,101,157,POINT (-85.58240543002174 10.418227980985947),-85.58240543002174,10.418227980985947
138,17,41,100,158,POINT (-85.58240543002174 10.462091980985946),-85.58240543002174,10.462091980985946
139,17,41,100,158,POINT (-85.58240543002174 10.505955980985945),-85.58240543002174,10.505955980985945
140,17,41,102,160,POINT (-85.58240543002174 10.549819980985944),-85.58240543002174,10.549819980985944
141,17,44,103,164,POINT (-85.58240543002174 10.593683980985944),-85.58240543002174,10.593683980985944
142,17,47,103,167,POINT (-85.58240543002174 10.637547980985943),-85.58240543002174,10.637547980985943
143,17,49,104,170,POINT (-85.58240543002174 10.681411980985942),-85.58240543002174,10.681411980985942
144,17,52,105,174,POINT (-85.58240543002174 10.725275980985941),-85.58240543002174,10.725275980985941
145,17,54,108,179,POINT (-85.58240543002174 10.76913998098594),-85.58240543002174,10.76913998098594
146,19,56,108,183,POINT (-85.58240543002174 10.81300398098594),-85.58240543002174,10.81300398098594
147,18,55,111,184,POINT (-85.58240543002174 10.856867980985939),-85.58240543002174,10.856867980985939
148,17,52,112,181,POINT (-85.58240543002174 10.900731980985938),-85.58240543002174,10.900731980985938
149,16,52,112,180,POINT (-85.58240543002174 10.944595980985937),-85.58240543002174,10.944595980985937
150,16,52,114,182,POINT (-85.58240543002174 10.988459980985937),-85.58240543002174,10.988459980985937
151,17,51,116,184,POINT (-85.58240543002174 11.032323980985936),-85.58240543002174,11.032323980985936
152,16,50,114,180,POINT (-85.58240543002174 11.076187980985935),-85.58240543002174,11.076187980985935
153,16,51,115,182,POINT (-85.58240543002174 11.120051980985934),-85.58240543002174,11.120051980985934
154,16,52,115,183,POINT (-85.58240543002174 11.163915980985934),-85.58240543002174,11.163915980985934
155,17,32,99,148,POINT (-85.54647343002173 9.935723980985955),-85.54647343002173,9.935723980985955
156,17,31,100,148,POINT (-85.54647343002173 9.979587980985954),-85.54647343002173,9.979587980985954
157,17,33,100,150,POINT (-85.54647343002173 10.023451980985953),-85.54647343002173,10.023451980985953
158,17,33,100,150,POINT (-85.54647343002173 10.067315980985953),-85.54647343002173,10.067315980985953
159,17,33,100,150,POINT (-85.54647343002173 10.111179980985952),-85.54647343002173,10.111179980985952
160,17,33,102,152,POINT (-85.54647343002173 10.155043980985951),-85.54647343002173,10.155043980985951
161,17,33,102,152,POINT (-85.54647343002173 10.19890798098595),-85.54647343002173,10.19890798098595
162,17,34,101,152,POINT (-85.54647343002173 10.24277198098595),-85.54647343002173,10.24277198098595
163,17,34,100,151,POINT (-85.54647343002173 10.286635980985949),-85.54647343002173,10.286635980985949
164,17,37,101,155,POINT (-85.54647343002173 10.330499980985948),-85.54647343002173,10.330499980985948
165,17,39,101,157,POINT (-85.54647343002173 10.374363980985947),-85.54647343002173,10.374363980985947
166,17,41,101,159,POINT (-85.54647343002173 10.418227980985947),-85.54647343002173,10.418227980985947
167,17,41,101,159,POINT (-85.54647343002173 10.462091980985946),-85.54647343002173,10.462091980985946
168,17,42,101,160,POINT (-85.54647343002173 10.505955980985945),-85.54647343002173,10.505955980985945
169,17,43,103,163,POINT (-85.54647343002173 10.549819980985944),-85.54647343002173,10.549819980985944
170,17,46,103,166,POINT (-85.54647343002173 10.593683980985944),-85.54647343002173,10.593683980985944
171,17,48,104,169,POINT (-85.54647343002173 10.637547980985943),-85.54647343002173,10.637547980985943
172,17,53,106,176,POINT (-85.54647343002173 10.681411980985942),-85.54647343002173,10.681411980985942
173,17,55,107,179,POINT (-85.54647343002173 10.725275980985941),-85.54647343002173,10.725275980985941
174,17,57,108,182,POINT (-85.54647343002173 10.76913998098594),-85.54647343002173,10.76913998098594
175,18,57,109,184,POINT (-85.54647343002173 10.81300398098594),-85.54647343002173,10.81300398098594
176,20,57,111,188,POINT (-85.54647343002173 10.856867980985939),-85.54647343002173,10.856867980985939
177,19,53,114,186,POINT (-85.54647343002173 10.900731980985938),-85.54647343002173,10.900731980985938
178,18,52,116,186,POINT (-85.54647343002173 10.944595980985937),-85.54647343002173,10.944595980985937
179,17,52,115,184,POINT (-85.54647343002173 10.988459980985937),-85.54647343002173,10.988459980985937
180,17,53,118,188,POINT (-85.54647343002173 11.032323980985936),-85.54647343002173,11.032323980985936
181,16,53,114,183,POINT (-85.54647343002173 11.076187980985935),-85.54647343002173,11.076187980985935
182,16,54,115,185,POINT (-85.54647343002173 11.120051980985934),-85.54647343002173,11.120051980985934
183,17,51,113,181,POINT (-85.54647343002173 11.163915980985934),-85.54647343002173,11.163915980985934
184,17,46,110,173,POINT (-85.54647343002173 11.207779980985933),-85.54647343002173,11.207779980985933
185,17,32,99,148,POINT (-85.51054143002173 9.891859980985956),-85.51054143002173,9.891859980985956
186,17,31,100,148,POINT (-85.51054143002173 9.935723980985955),-85.51054143002173,9.935723980985955
187,17,31,100,148,POINT (-85.51054143002173 9.979587980985954),-85.51054143002173,9.979587980985954
188,17,32,100,149,POINT (-85.51054143002173 10.023451980985953),-85.51054143002173,10.023451980985953
189,17,33,100,150,POINT (-85.51054143002173 10.067315980985953),-85.51054143002173,10.067315980985953
190,17,33,100,150,POINT (-85.51054143002173 10.111179980985952),-85.51054143002173,10.111179980985952
191,17,33,101,151,POINT (-85.51054143002173 10.155043980985951),-85.51054143002173,10.155043980985951
192,17,34,102,153,POINT (-85.51054143002173 10.19890798098595),-85.51054143002173,10.19890798098595
193,17,35,101,153,POINT (-85.51054143002173 10.24277198098595),-85.51054143002173,10.24277198098595
194,17,35,101,153,POINT (-85.51054143002173 10.286635980985949),-85.51054143002173,10.286635980985949
195,17,37,101,155,POINT (-85.51054143002173 10.330499980985948),-85.51054143002173,10.330499980985948
196,17,39,101,157,POINT (-85.51054143002173 10.374363980985947),-85.51054143002173,10.374363980985947
197,17,42,102,161,POINT (-85.51054143002173 10.418227980985947),-85.51054143002173,10.418227980985947
198,17,42,101,160,POINT (-85.51054143002173 10.462091980985946),-85.51054143002173,10.462091980985946
199,17,43,102,162,POINT (-85.51054143002173 10.505955980985945),-85.51054143002173,10.505955980985945
200,17,44,103,164,POINT (-85.51054143002173 10.549819980985944),-85.51054143002173,10.549819980985944
201,17,46,104,167,POINT (-85.51054143002173 10.593683980985944),-85.51054143002173,10.593683980985944
202,17,51,105,173,POINT (-85.51054143002173 10.637547980985943),-85.51054143002173,10.637547980985943
203,17,54,106,177,POINT (-85.51054143002173 10.681411980985942),-85.51054143002173,10.681411980985942
204,17,61,107,185,POINT (-85.51054143002173 10.725275980985941),-85.51054143002173,10.725275980985941
205,17,64,108,189,POINT (-85.51054143002173 10.76913998098594),-85.51054143002173,10.76913998098594
206,19,65,111,195,POINT (-85.51054143002173 10.81300398098594),-85.51054143002173,10.81300398098594
207,19,58,113,190,POINT (-85.51054143002173 10.856867980985939),-85.51054143002173,10.856867980985939
208,20,54,115,189,POINT (-85.51054143002173 10.900731980985938),-85.51054143002173,10.900731980985938
209,22,57,116,195,POINT (-85.51054143002173 10.944595980985937),-85.51054143002173,10.944595980985937
210,23,55,116,194,POINT (-85.51054143002173 10.988459980985937),-85.51054143002173,10.988459980985937
211,19,55,118,192,POINT (-85.51054143002173 11.032323980985936),-85.51054143002173,11.032323980985936
212,18,51,118,187,POINT (-85.51054143002173 11.076187980985935),-85.51054143002173,11.076187980985935
213,18,48,115,181,POINT (-85.51054143002173 11.120051980985934),-85.51054143002173,11.120051980985934
214,16,45,112,173,POINT (-85.51054143002173 11.163915980985934),-85.51054143002173,11.163915980985934
215,17,32,100,149,POINT (-85.47460943002173 9.891859980985956),-85.47460943002173,9.891859980985956
216,17,31,100,148,POINT (-85.47460943002173 9.935723980985955),-85.47460943002173,9.935723980985955
217,17,31,100,148,POINT (-85.47460943002173 9.979587980985954),-85.47460943002173,9.979587980985954
218,17,31,100,148,POINT (-85.47460943002173 10.023451980985953),-85.47460943002173,10.023451980985953
219,17,33,100,150,POINT (-85.47460943002173 10.067315980985953),-85.47460943002173,10.067315980985953
220,17,33,100,150,POINT (-85.47460943002173 10.111179980985952),-85.47460943002173,10.111179980985952
221,17,33,101,151,POINT (-85.47460943002173 10.155043980985951),-85.47460943002173,10.155043980985951
222,17,34,102,153,POINT (-85.47460943002173 10.19890798098595),-85.47460943002173,10.19890798098595
223,17,35,101,153,POINT (-85.47460943002173 10.24277198098595),-85.47460943002173,10.24277198098595
224,17,37,101,155,POINT (-85.47460943002173 10.286635980985949),-85.47460943002173,10.286635980985949
225,17,37,101,155,POINT (-85.47460943002173 10.330499980985948),-85.47460943002173,10.330499980985948
226,17,41,102,160,POINT (-85.47460943002173 10.374363980985947),-85.47460943002173,10.374363980985947
227,17,42,102,161,POINT (-85.47460943002173 10.418227980985947),-85.47460943002173,10.418227980985947
228,17,43,101,161,POINT (-85.47460943002173 10.462091980985946),-85.47460943002173,10.462091980985946
229,17,44,103,164,POINT (-85.47460943002173 10.505955980985945),-85.47460943002173,10.505955980985945
230,17,47,103,167,POINT (-85.47460943002173 10.549819980985944),-85.47460943002173,10.549819980985944
231,17,48,105,170,POINT (-85.47460943002173 10.593683980985944),-85.47460943002173,10.593683980985944
232,17,53,105,175,POINT (-85.47460943002173 10.637547980985943),-85.47460943002173,10.637547980985943
233,17,60,107,184,POINT (-85.47460943002173 10.681411980985942),-85.47460943002173,10.681411980985942
234,17,63,109,189,POINT (-85.47460943002173 10.725275980985941),-85.47460943002173,10.725275980985941
235,18,70,111,199,POINT (-85.47460943002173 10.76913998098594),-85.47460943002173,10.76913998098594
236,19,69,114,202,POINT (-85.47460943002173 10.81300398098594),-85.47460943002173,10.81300398098594
237,22,64,116,202,POINT (-85.47460943002173 10.856867980985939),-85.47460943002173,10.856867980985939
238,26,58,119,203,POINT (-85.47460943002173 10.900731980985938),-85.47460943002173,10.900731980985938
239,28,56,121,205,POINT (-85.47460943002173 10.944595980985937),-85.47460943002173,10.944595980985937
240,28,55,121,204,POINT (-85.47460943002173 10.988459980985937),-85.47460943002173,10.988459980985937
241,25,53,122,200,POINT (-85.47460943002173 11.032323980985936),-85.47460943002173,11.032323980985936
242,18,50,118,186,POINT (-85.47460943002173 11.076187980985935),-85.47460943002173,11.076187980985935
243,20,48,114,182,POINT (-85.47460943002173 11.120051980985934),-85.47460943002173,11.120051980985934
244,19,45,109,173,POINT (-85.47460943002173 11.163915980985934),-85.47460943002173,11.163915980985934
245,17,32,100,149,POINT (-85.43867743002173 9.891859980985956),-85.43867743002173,9.891859980985956
246,17,31,100,148,POINT (-85.43867743002173 9.935723980985955),-85.43867743002173,9.935723980985955
247,17,31,101,149,POINT (-85.43867743002173 9.979587980985954),-85.43867743002173,9.979587980985954
248,17,32,100,149,POINT (-85.43867743002173 10.023451980985953),-85.43867743002173,10.023451980985953
249,17,32,100,149,POINT (-85.43867743002173 10.067315980985953),-85.43867743002173,10.067315980985953
250,17,33,100,150,POINT (-85.43867743002173 10.111179980985952),-85.43867743002173,10.111179980985952
251,17,33,100,150,POINT (-85.43867743002173 10.155043980985951),-85.43867743002173,10.155043980985951
252,17,35,102,154,POINT (-85.43867743002173 10.19890798098595),-85.43867743002173,10.19890798098595
253,17,35,101,153,POINT (-85.43867743002173 10.24277198098595),-85.43867743002173,10.24277198098595
254,17,37,102,156,POINT (-85.43867743002173 10.286635980985949),-85.43867743002173,10.286635980985949
255,17,38,103,158,POINT (-85.43867743002173 10.330499980985948),-85.43867743002173,10.330499980985948
256,17,42,104,163,POINT (-85.43867743002173 10.374363980985947),-85.43867743002173,10.374363980985947
257,17,42,104,163,POINT (-85.43867743002173 10.418227980985947),-85.43867743002173,10.418227980985947
258,17,43,103,163,POINT (-85.43867743002173 10.462091980985946),-85.43867743002173,10.462091980985946
259,17,44,104,165,POINT (-85.43867743002173 10.505955980985945),-85.43867743002173,10.505955980985945
260,17,47,105,169,POINT (-85.43867743002173 10.549819980985944),-85.43867743002173,10.549819980985944
261,17,51,108,176,POINT (-85.43867743002173 10.593683980985944),-85.43867743002173,10.593683980985944
262,17,55,108,180,POINT (-85.43867743002173 10.637547980985943),-85.43867743002173,10.637547980985943
263,17,60,111,188,POINT (-85.43867743002173 10.681411980985942),-85.43867743002173,10.681411980985942
264,18,62,112,192,POINT (-85.43867743002173 10.725275980985941),-85.43867743002173,10.725275980985941
265,19,66,116,201,POINT (-85.43867743002173 10.76913998098594),-85.43867743002173,10.76913998098594
266,24,68,118,210,POINT (-85.43867743002173 10.81300398098594),-85.43867743002173,10.81300398098594
267,30,68,120,218,POINT (-85.43867743002173 10.856867980985939),-85.43867743002173,10.856867980985939
268,36,56,123,215,POINT (-85.43867743002173 10.900731980985938),-85.43867743002173,10.900731980985938
269,31,56,124,211,POINT (-85.43867743002173 10.944595980985937),-85.43867743002173,10.944595980985937
270,34,57,123,214,POINT (-85.43867743002173 10.988459980985937),-85.43867743002173,10.988459980985937
271,29,51,122,202,POINT (-85.43867743002173 11.032323980985936),-85.43867743002173,11.032323980985936
272,25,51,117,193,POINT (-85.43867743002173 11.076187980985935),-85.43867743002173,11.076187980985935
273,21,48,115,184,POINT (-85.43867743002173 11.120051980985934),-85.43867743002173,11.120051980985934
274,19,44,108,171,POINT (-85.43867743002173 11.163915980985934),-85.43867743002173,11.163915980985934
275,17,32,100,149,POINT (-85.40274543002172 9.891859980985956),-85.40274543002172,9.891859980985956
276,17,31,101,149,POINT (-85.40274543002172 9.935723980985955),-85.40274543002172,9.935723980985955
277,17,31,101,149,POINT (-85.40274543002172 9.979587980985954),-85.40274543002172,9.979587980985954
278,17,32,101,150,POINT (-85.40274543002172 10.023451980985953),-85.40274543002172,10.023451980985953
279,17,32,100,149,POINT (-85.40274543002172 10.067315980985953),-85.40274543002172,10.067315980985953
280,17,32,100,149,POINT (-85.40274543002172 10.111179980985952),-85.40274543002172,10.111179980985952
281,17,34,100,151,POINT (-85.40274543002172 10.155043980985951),-85.40274543002172,10.155043980985951
282,17,35,101,153,POINT (-85.40274543002172 10.19890798098595),-85.40274543002172,10.19890798098595
283,17,36,102,155,POINT (-85.40274543002172 10.24277198098595),-85.40274543002172,10.24277198098595
284,17,38,103,158,POINT (-85.40274543002172 10.286635980985949),-85.40274543002172,10.286635980985949
285,17,41,105,163,POINT (-85.40274543002172 10.330499980985948),-85.40274543002172,10.330499980985948
286,17,42,104,163,POINT (-85.40274543002172 10.374363980985947),-85.40274543002172,10.374363980985947
287,17,42,105,164,POINT (-85.40274543002172 10.418227980985947),-85.40274543002172,10.418227980985947
288,17,44,105,166,POINT (-85.40274543002172 10.462091980985946),-85.40274543002172,10.462091980985946
289,17,45,106,168,POINT (-85.40274543002172 10.505955980985945),-85.40274543002172,10.505955980985945
290,17,49,107,173,POINT (-85.40274543002172 10.549819980985944),-85.40274543002172,10.549819980985944
291,17,53,110,180,POINT (-85.40274543002172 10.593683980985944),-85.40274543002172,10.593683980985944
292,17,57,112,186,POINT (-85.40274543002172 10.637547980985943),-85.40274543002172,10.637547980985943
293,17,63,114,194,POINT (-85.40274543002172 10.681411980985942),-85.40274543002172,10.681411980985942
294,19,67,117,203,POINT (-85.40274543002172 10.725275980985941),-85.40274543002172,10.725275980985941
295,22,69,121,212,POINT (-85.40274543002172 10.76913998098594),-85.40274543002172,10.76913998098594
296,26,67,122,215,POINT (-85.40274543002172 10.81300398098594),-85.40274543002172,10.81300398098594
297,30,65,123,218,POINT (-85.40274543002172 10.856867980985939),-85.40274543002172,10.856867980985939
298,38,59,125,222,POINT (-85.40274543002172 10.900731980985938),-85.40274543002172,10.900731980985938
299,39,58,124,221,POINT (-85.40274543002172 10.944595980985937),-85.40274543002172,10.944595980985937
300,35,56,121,212,POINT (-85.40274543002172 10.988459980985937),-85.40274543002172,10.988459980985937
301,33,51,121,205,POINT (-85.40274543002172 11.032323980985936),-85.40274543002172,11.032323980985936
302,25,49,118,192,POINT (-85.40274543002172 11.076187980985935),-85.40274543002172,11.076187980985935
303,25,46,112,183,POINT (-85.40274543002172 11.120051980985934),-85.40274543002172,11.120051980985934
304,17,32,99,148,POINT (-85.36681343002172 9.847995980985957),-85.36681343002172,9.847995980985957
305,17,32,101,150,POINT (-85.36681343002172 9.891859980985956),-85.36681343002172,9.891859980985956
306,17,31,100,148,POINT (-85.36681343002172 9.935723980985955),-85.36681343002172,9.935723980985955
307,17,30,100,147,POINT (-85.36681343002172 9.979587980985954),-85.36681343002172,9.979587980985954
308,17,32,100,149,POINT (-85.36681343002172 10.023451980985953),-85.36681343002172,10.023451980985953
309,17,32,100,149,POINT (-85.36681343002172 10.067315980985953),-85.36681343002172,10.067315980985953
310,17,33,100,150,POINT (-85.36681343002172 10.111179980985952),-85.36681343002172,10.111179980985952
311,17,34,102,153,POINT (-85.36681343002172 10.155043980985951),-85.36681343002172,10.155043980985951
312,17,36,103,156,POINT (-85.36681343002172 10.19890798098595),-85.36681343002172,10.19890798098595
313,17,38,102,157,POINT (-85.36681343002172 10.24277198098595),-85.36681343002172,10.24277198098595
314,17,39,105,161,POINT (-85.36681343002172 10.286635980985949),-85.36681343002172,10.286635980985949
315,17,42,105,164,POINT (-85.36681343002172 10.330499980985948),-85.36681343002172,10.330499980985948
316,17,43,106,166,POINT (-85.36681343002172 10.374363980985947),-85.36681343002172,10.374363980985947
317,17,44,107,168,POINT (-85.36681343002172 10.418227980985947),-85.36681343002172,10.418227980985947
318,17,44,110,171,POINT (-85.36681343002172 10.462091980985946),-85.36681343002172,10.462091980985946
319,17,45,110,172,POINT (-85.36681343002172 10.505955980985945),-85.36681343002172,10.505955980985945
320,17,52,110,179,POINT (-85.36681343002172 10.549819980985944),-85.36681343002172,10.549819980985944
321,17,53,112,182,POINT (-85.36681343002172 10.593683980985944),-85.36681343002172,10.593683980985944
322,17,60,115,192,POINT (-85.36681343002172 10.637547980985943),-85.36681343002172,10.637547980985943
323,19,68,116,203,POINT (-85.36681343002172 10.681411980985942),-85.36681343002172,10.681411980985942
324,21,65,122,208,POINT (-85.36681343002172 10.725275980985941),-85.36681343002172,10.725275980985941
325,23,68,124,215,POINT (-85.36681343002172 10.76913998098594),-85.36681343002172,10.76913998098594
326,24,62,126,212,POINT (-85.36681343002172 10.81300398098594),-85.36681343002172,10.81300398098594
327,33,64,127,224,POINT (-85.36681343002172 10.856867980985939),-85.36681343002172,10.856867980985939
328,43,60,125,228,POINT (-85.36681343002172 10.900731980985938),-85.36681343002172,10.900731980985938
329,43,60,123,226,POINT (-85.36681343002172 10.944595980985937),-85.36681343002172,10.944595980985937
330,40,56,122,218,POINT (-85.36681343002172 10.988459980985937),-85.36681343002172,10.988459980985937
331,32,53,121,206,POINT (-85.36681343002172 11.032323980985936),-85.36681343002172,11.032323980985936
332,27,48,114,189,POINT (-85.36681343002172 11.076187980985935),-85.36681343002172,11.076187980985935
333,24,44,111,179,POINT (-85.36681343002172 11.120051980985934),-85.36681343002172,11.120051980985934
334,17,32,99,148,POINT (-85.33088143002172 9.847995980985957),-85.33088143002172,9.847995980985957
335,17,31,100,148,POINT (-85.33088143002172 9.891859980985956),-85.33088143002172,9.891859980985956
336,17,31,100,148,POINT (-85.33088143002172 9.935723980985955),-85.33088143002172,9.935723980985955
337,17,31,101,149,POINT (-85.33088143002172 9.979587980985954),-85.33088143002172,9.979587980985954
338,17,32,101,150,POINT (-85.33088143002172 10.023451980985953),-85.33088143002172,10.023451980985953
339,17,33,101,151,POINT (-85.33088143002172 10.067315980985953),-85.33088143002172,10.067315980985953
340,17,33,102,152,POINT (-85.33088143002172 10.111179980985952),-85.33088143002172,10.111179980985952
341,17,35,102,154,POINT (-85.33088143002172 10.155043980985951),-85.33088143002172,10.155043980985951
342,17,37,102,156,POINT (-85.33088143002172 10.19890798098595),-85.33088143002172,10.19890798098595
343,17,38,103,158,POINT (-85.33088143002172 10.24277198098595),-85.33088143002172,10.24277198098595
344,17,39,105,161,POINT (-85.33088143002172 10.286635980985949),-85.33088143002172,10.286635980985949
345,17,43,107,167,POINT (-85.33088143002172 10.330499980985948),-85.33088143002172,10.330499980985948
346,17,44,108,169,POINT (-85.33088143002172 10.374363980985947),-85.33088143002172,10.374363980985947
347,17,44,109,170,POINT (-85.33088143002172 10.418227980985947),-85.33088143002172,10.418227980985947
348,17,44,111,172,POINT (-85.33088143002172 10.462091980985946),-85.33088143002172,10.462091980985946
349,17,48,109,174,POINT (-85.33088143002172 10.505955980985945),-85.33088143002172,10.505955980985945
350,17,51,112,180,POINT (-85.33088143002172 10.549819980985944),-85.33088143002172,10.549819980985944
351,17,53,115,185,POINT (-85.33088143002172 10.593683980985944),-85.33088143002172,10.593683980985944
352,17,66,117,200,POINT (-85.33088143002172 10.637547980985943),-85.33088143002172,10.637547980985943
353,20,67,120,207,POINT (-85.33088143002172 10.681411980985942),-85.33088143002172,10.681411980985942
354,23,69,124,216,POINT (-85.33088143002172 10.725275980985941),-85.33088143002172,10.725275980985941
355,27,66,126,219,POINT (-85.33088143002172 10.76913998098594),-85.33088143002172,10.76913998098594
356,27,57,129,213,POINT (-85.33088143002172 10.81300398098594),-85.33088143002172,10.81300398098594
357,39,63,126,228,POINT (-85.33088143002172 10.856867980985939),-85.33088143002172,10.856867980985939
358,48,58,128,234,POINT (-85.33088143002172 10.900731980985938),-85.33088143002172,10.900731980985938
359,46,59,126,231,POINT (-85.33088143002172 10.944595980985937),-85.33088143002172,10.944595980985937
360,40,53,125,218,POINT (-85.33088143002172 10.988459980985937),-85.33088143002172,10.988459980985937
361,34,47,121,202,POINT (-85.33088143002172 11.032323980985936),-85.33088143002172,11.032323980985936
362,28,45,112,185,POINT (-85.33088143002172 11.076187980985935),-85.33088143002172,11.076187980985935
363,24,40,108,172,POINT (-85.33088143002172 11.120051980985934),-85.33088143002172,11.120051980985934
364,17,28,99,144,POINT (-85.29494943002172 9.804131980985957),-85.29494943002172,9.804131980985957
365,17,32,101,150,POINT (-85.29494943002172 9.847995980985957),-85.29494943002172,9.847995980985957
366,17,31,101,149,POINT (-85.29494943002172 9.891859980985956),-85.29494943002172,9.891859980985956
367,17,31,101,149,POINT (-85.29494943002172 9.935723980985955),-85.29494943002172,9.935723980985955
368,17,31,101,149,POINT (-85.29494943002172 9.979587980985954),-85.29494943002172,9.979587980985954
369,17,33,101,151,POINT (-85.29494943002172 10.023451980985953),-85.29494943002172,10.023451980985953
370,17,33,101,151,POINT (-85.29494943002172 10.067315980985953),-85.29494943002172,10.067315980985953
371,17,34,102,153,POINT (-85.29494943002172 10.111179980985952),-85.29494943002172,10.111179980985952
372,17,34,102,153,POINT (-85.29494943002172 10.155043980985951),-85.29494943002172,10.155043980985951
373,17,38,103,158,POINT (-85.29494943002172 10.19890798098595),-85.29494943002172,10.19890798098595
374,17,39,104,160,POINT (-85.29494943002172 10.24277198098595),-85.29494943002172,10.24277198098595
375,17,39,105,161,POINT (-85.29494943002172 10.286635980985949),-85.29494943002172,10.286635980985949
376,17,42,108,167,POINT (-85.29494943002172 10.330499980985948),-85.29494943002172,10.330499980985948
377,17,45,108,170,POINT (-85.29494943002172 10.374363980985947),-85.29494943002172,10.374363980985947
378,17,45,111,173,POINT (-85.29494943002172 10.418227980985947),-85.29494943002172,10.418227980985947
379,17,45,111,173,POINT (-85.29494943002172 10.462091980985946),-85.29494943002172,10.462091980985946
380,17,49,112,178,POINT (-85.29494943002172 10.505955980985945),-85.29494943002172,10.505955980985945
381,17,51,114,182,POINT (-85.29494943002172 10.549819980985944),-85.29494943002172,10.549819980985944
382,17,57,117,191,POINT (-85.29494943002172 10.593683980985944),-85.29494943002172,10.593683980985944
383,19,63,119,201,POINT (-85.29494943002172 10.637547980985943),-85.29494943002172,10.637547980985943
384,21,66,125,212,POINT (-85.29494943002172 10.681411980985942),-85.29494943002172,10.681411980985942
385,25,66,127,218,POINT (-85.29494943002172 10.725275980985941),-85.29494943002172,10.725275980985941
386,30,66,129,225,POINT (-85.29494943002172 10.76913998098594),-85.29494943002172,10.76913998098594
387,30,59,127,216,POINT (-85.29494943002172 10.81300398098594),-85.29494943002172,10.81300398098594
388,43,61,132,236,POINT (-85.29494943002172 10.856867980985939),-85.29494943002172,10.856867980985939
389,48,58,128,234,POINT (-85.29494943002172 10.900731980985938),-85.29494943002172,10.900731980985938
390,46,54,128,228,POINT (-85.29494943002172 10.944595980985937),-85.29494943002172,10.944595980985937
391,42,56,126,224,POINT (-85.29494943002172 10.988459980985937),-85.29494943002172,10.988459980985937
392,34,51,119,204,POINT (-85.29494943002172 11.032323980985936),-85.29494943002172,11.032323980985936
393,28,47,114,189,POINT (-85.29494943002172 11.076187980985935),-85.29494943002172,11.076187980985935
394,17,11,99,127,POINT (-85.25901743002171 9.760267980985958),-85.25901743002171,9.760267980985958
395,17,32,101,150,POINT (-85.25901743002171 9.804131980985957),-85.25901743002171,9.804131980985957
396,17,31,101,149,POINT (-85.25901743002171 9.847995980985957),-85.25901743002171,9.847995980985957
397,17,31,101,149,POINT (-85.25901743002171 9.891859980985956),-85.25901743002171,9.891859980985956
398,17,31,101,149,POINT (-85.25901743002171 9.935723980985955),-85.25901743002171,9.935723980985955
399,17,32,101,150,POINT (-85.25901743002171 9.979587980985954),-85.25901743002171,9.979587980985954
400,17,33,101,151,POINT (-85.25901743002171 10.023451980985953),-85.25901743002171,10.023451980985953
401,17,34,101,152,POINT (-85.25901743002171 10.067315980985953),-85.25901743002171,10.067315980985953
402,17,34,101,152,POINT (-85.25901743002171 10.111179980985952),-85.25901743002171,10.111179980985952
403,17,34,102,153,POINT (-85.25901743002171 10.155043980985951),-85.25901743002171,10.155043980985951
404,17,37,102,156,POINT (-85.25901743002171 10.19890798098595),-85.25901743002171,10.19890798098595
405,17,38,105,160,POINT (-85.25901743002171 10.24277198098595),-85.25901743002171,10.24277198098595
406,17,42,109,168,POINT (-85.25901743002171 10.286635980985949),-85.25901743002171,10.286635980985949
407,17,43,109,169,POINT (-85.25901743002171 10.330499980985948),-85.25901743002171,10.330499980985948
408,17,45,109,171,POINT (-85.25901743002171 10.374363980985947),-85.25901743002171,10.374363980985947
409,17,46,112,175,POINT (-85.25901743002171 10.418227980985947),-85.25901743002171,10.418227980985947
410,17,48,113,178,POINT (-85.25901743002171 10.462091980985946),-85.25901743002171,10.462091980985946
411,17,49,114,180,POINT (-85.25901743002171 10.505955980985945),-85.25901743002171,10.505955980985945
412,17,54,116,187,POINT (-85.25901743002171 10.549819980985944),-85.25901743002171,10.549819980985944
413,18,58,118,194,POINT (-85.25901743002171 10.593683980985944),-85.25901743002171,10.593683980985944
414,19,64,120,203,POINT (-85.25901743002171 10.637547980985943),-85.25901743002171,10.637547980985943
415,23,68,127,218,POINT (-85.25901743002171 10.681411980985942),-85.25901743002171,10.681411980985942
416,27,65,130,222,POINT (-85.25901743002171 10.725275980985941),-85.25901743002171,10.725275980985941
417,32,67,131,230,POINT (-85.25901743002171 10.76913998098594),-85.25901743002171,10.76913998098594
418,37,61,131,229,POINT (-85.25901743002171 10.81300398098594),-85.25901743002171,10.81300398098594
419,45,59,130,234,POINT (-85.25901743002171 10.856867980985939),-85.25901743002171,10.856867980985939
420,48,55,129,232,POINT (-85.25901743002171 10.900731980985938),-85.25901743002171,10.900731980985938
421,46,57,127,230,POINT (-85.25901743002171 10.944595980985937),-85.25901743002171,10.944595980985937
422,41,54,124,219,POINT (-85.25901743002171 10.988459980985937),-85.25901743002171,10.988459980985937
423,32,52,118,202,POINT (-85.25901743002171 11.032323980985936),-85.25901743002171,11.032323980985936
424,27,48,111,186,POINT (-85.25901743002171 11.076187980985935),-85.25901743002171,11.076187980985935
425,17,8,87,112,POINT (-85.22308543002171 9.716403980985959),-85.22308543002171,9.716403980985959
426,17,32,101,150,POINT (-85.22308543002171 9.760267980985958),-85.22308543002171,9.760267980985958
427,17,32,101,150,POINT (-85.22308543002171 9.804131980985957),-85.22308543002171,9.804131980985957
428,17,31,101,149,POINT (-85.22308543002171 9.847995980985957),-85.22308543002171,9.847995980985957
429,17,31,101,149,POINT (-85.22308543002171 9.891859980985956),-85.22308543002171,9.891859980985956
430,17,32,101,150,POINT (-85.22308543002171 9.935723980985955),-85.22308543002171,9.935723980985955
431,17,32,101,150,POINT (-85.22308543002171 9.979587980985954),-85.22308543002171,9.979587980985954
432,17,33,101,151,POINT (-85.22308543002171 10.023451980985953),-85.22308543002171,10.023451980985953
433,17,34,101,152,POINT (-85.22308543002171 10.067315980985953),-85.22308543002171,10.067315980985953
434,0,5,26,31,POINT (-85.22308543002171 10.111179980985952),-85.22308543002171,10.111179980985952
435,0,5,26,31,POINT (-85.22308543002171 10.155043980985951),-85.22308543002171,10.155043980985951
436,19,16,106,141,POINT (-85.22308543002171 10.19890798098595),-85.22308543002171,10.19890798098595
437,19,40,109,168,POINT (-85.22308543002171 10.24277198098595),-85.22308543002171,10.24277198098595
438,18,43,111,172,POINT (-85.22308543002171 10.286635980985949),-85.22308543002171,10.286635980985949
439,18,45,111,174,POINT (-85.22308543002171 10.330499980985948),-85.22308543002171,10.330499980985948
440,18,47,112,177,POINT (-85.22308543002171 10.374363980985947),-85.22308543002171,10.374363980985947
441,19,48,113,180,POINT (-85.22308543002171 10.418227980985947),-85.22308543002171,10.418227980985947
442,18,51,115,184,POINT (-85.22308543002171 10.462091980985946),-85.22308543002171,10.462091980985946
443,18,55,115,188,POINT (-85.22308543002171 10.505955980985945),-85.22308543002171,10.505955980985945
444,18,57,117,192,POINT (-85.22308543002171 10.549819980985944),-85.22308543002171,10.549819980985944
445,19,59,119,197,POINT (-85.22308543002171 10.593683980985944),-85.22308543002171,10.593683980985944
446,21,64,124,209,POINT (-85.22308543002171 10.637547980985943),-85.22308543002171,10.637547980985943
447,26,64,129,219,POINT (-85.22308543002171 10.681411980985942),-85.22308543002171,10.681411980985942
448,30,64,130,224,POINT (-85.22308543002171 10.725275980985941),-85.22308543002171,10.725275980985941
449,33,64,131,228,POINT (-85.22308543002171 10.76913998098594),-85.22308543002171,10.76913998098594
450,41,59,130,230,POINT (-85.22308543002171 10.81300398098594),-85.22308543002171,10.81300398098594
451,48,54,131,233,POINT (-85.22308543002171 10.856867980985939),-85.22308543002171,10.856867980985939
452,49,59,128,236,POINT (-85.22308543002171 10.900731980985938),-85.22308543002171,10.900731980985938
453,46,56,125,227,POINT (-85.22308543002171 10.944595980985937),-85.22308543002171,10.944595980985937
454,41,53,124,218,POINT (-85.22308543002171 10.988459980985937),-85.22308543002171,10.988459980985937
455,31,52,117,200,POINT (-85.22308543002171 11.032323980985936),-85.22308543002171,11.032323980985936
456,22,47,109,178,POINT (-85.22308543002171 11.076187980985935),-85.22308543002171,11.076187980985935
457,19,32,98,149,POINT (-85.18715343002171 9.67253998098596),-85.18715343002171,9.67253998098596
458,18,32,100,150,POINT (-85.18715343002171 9.716403980985959),-85.18715343002171,9.716403980985959
459,17,32,101,150,POINT (-85.18715343002171 9.760267980985958),-85.18715343002171,9.760267980985958
460,17,31,101,149,POINT (-85.18715343002171 9.804131980985957),-85.18715343002171,9.804131980985957
461,17,31,101,149,POINT (-85.18715343002171 9.847995980985957),-85.18715343002171,9.847995980985957
462,17,31,101,149,POINT (-85.18715343002171 9.891859980985956),-85.18715343002171,9.891859980985956
463,17,32,101,150,POINT (-85.18715343002171 9.935723980985955),-85.18715343002171,9.935723980985955
464,17,32,101,150,POINT (-85.18715343002171 9.979587980985954),-85.18715343002171,9.979587980985954
465,17,34,101,152,POINT (-85.18715343002171 10.023451980985953),-85.18715343002171,10.023451980985953
466,0,7,26,33,POINT (-85.18715343002171 10.067315980985953),-85.18715343002171,10.067315980985953
467,0,9,1,10,POINT (-85.18715343002171 10.111179980985952),-85.18715343002171,10.111179980985952
468,0,6,26,32,POINT (-85.18715343002171 10.155043980985951),-85.18715343002171,10.155043980985951
469,20,39,108,167,POINT (-85.18715343002171 10.19890798098595),-85.18715343002171,10.19890798098595
470,20,40,110,170,POINT (-85.18715343002171 10.24277198098595),-85.18715343002171,10.24277198098595
471,21,43,111,175,POINT (-85.18715343002171 10.286635980985949),-85.18715343002171,10.286635980985949
472,21,48,110,179,POINT (-85.18715343002171 10.330499980985948),-85.18715343002171,10.330499980985948
473,21,50,114,185,POINT (-85.18715343002171 10.374363980985947),-85.18715343002171,10.374363980985947
474,19,52,115,186,POINT (-85.18715343002171 10.418227980985947),-85.18715343002171,10.418227980985947
475,19,54,116,189,POINT (-85.18715343002171 10.462091980985946),-85.18715343002171,10.462091980985946
476,19,56,117,192,POINT (-85.18715343002171 10.505955980985945),-85.18715343002171,10.505955980985945
477,21,56,118,195,POINT (-85.18715343002171 10.549819980985944),-85.18715343002171,10.549819980985944
478,19,60,121,200,POINT (-85.18715343002171 10.593683980985944),-85.18715343002171,10.593683980985944
479,26,65,128,219,POINT (-85.18715343002171 10.637547980985943),-85.18715343002171,10.637547980985943
480,32,59,129,220,POINT (-85.18715343002171 10.681411980985942),-85.18715343002171,10.681411980985942
481,32,60,130,222,POINT (-85.18715343002171 10.725275980985941),-85.18715343002171,10.725275980985941
482,38,59,130,227,POINT (-85.18715343002171 10.76913998098594),-85.18715343002171,10.76913998098594
483,43,58,132,233,POINT (-85.18715343002171 10.81300398098594),-85.18715343002171,10.81300398098594
484,47,55,130,232,POINT (-85.18715343002171 10.856867980985939),-85.18715343002171,10.856867980985939
485,48,57,127,232,POINT (-85.18715343002171 10.900731980985938),-85.18715343002171,10.900731980985938
486,44,53,124,221,POINT (-85.18715343002171 10.944595980985937),-85.18715343002171,10.944595980985937
487,38,52,123,213,POINT (-85.18715343002171 10.988459980985937),-85.18715343002171,10.988459980985937
488,30,53,116,199,POINT (-85.18715343002171 11.032323980985936),-85.18715343002171,11.032323980985936
489,19,32,99,150,POINT (-85.1512214300217 9.62867598098596),-85.1512214300217,9.62867598098596
490,19,32,99,150,POINT (-85.1512214300217 9.67253998098596),-85.1512214300217,9.67253998098596
491,18,32,100,150,POINT (-85.1512214300217 9.716403980985959),-85.1512214300217,9.716403980985959
492,18,31,101,150,POINT (-85.1512214300217 9.760267980985958),-85.1512214300217,9.760267980985958
493,17,31,101,149,POINT (-85.1512214300217 9.804131980985957),-85.1512214300217,9.804131980985957
494,17,31,101,149,POINT (-85.1512214300217 9.847995980985957),-85.1512214300217,9.847995980985957
495,17,31,101,149,POINT (-85.1512214300217 9.891859980985956),-85.1512214300217,9.891859980985956
496,17,32,101,150,POINT (-85.1512214300217 9.935723980985955),-85.1512214300217,9.935723980985955
497,17,33,101,151,POINT (-85.1512214300217 9.979587980985954),-85.1512214300217,9.979587980985954
498,0,5,26,31,POINT (-85.1512214300217 10.023451980985953),-85.1512214300217,10.023451980985953
499,0,5,0,5,POINT (-85.1512214300217 10.067315980985953),-85.1512214300217,10.067315980985953
500,0,10,0,10,POINT (-85.1512214300217 10.111179980985952),-85.1512214300217,10.111179980985952
501,0,7,26,33,POINT (-85.1512214300217 10.155043980985951),-85.1512214300217,10.155043980985951
502,21,38,110,169,POINT (-85.1512214300217 10.19890798098595),-85.1512214300217,10.19890798098595
503,23,42,111,176,POINT (-85.1512214300217 10.24277198098595),-85.1512214300217,10.24277198098595
504,23,43,112,178,POINT (-85.1512214300217 10.286635980985949),-85.1512214300217,10.286635980985949
505,22,45,113,180,POINT (-85.1512214300217 10.330499980985948),-85.1512214300217,10.330499980985948
506,21,50,113,184,POINT (-85.1512214300217 10.374363980985947),-85.1512214300217,10.374363980985947
507,21,52,116,189,POINT (-85.1512214300217 10.418227980985947),-85.1512214300217,10.418227980985947
508,21,55,115,191,POINT (-85.1512214300217 10.462091980985946),-85.1512214300217,10.462091980985946
509,22,55,115,192,POINT (-85.1512214300217 10.505955980985945),-85.1512214300217,10.505955980985945
510,23,58,116,197,POINT (-85.1512214300217 10.549819980985944),-85.1512214300217,10.549819980985944
511,26,61,123,210,POINT (-85.1512214300217 10.593683980985944),-85.1512214300217,10.593683980985944
512,31,58,126,215,POINT (-85.1512214300217 10.637547980985943),-85.1512214300217,10.637547980985943
513,34,60,126,220,POINT (-85.1512214300217 10.681411980985942),-85.1512214300217,10.681411980985942
514,30,54,130,214,POINT (-85.1512214300217 10.725275980985941),-85.1512214300217,10.725275980985941
515,34,53,131,218,POINT (-85.1512214300217 10.76913998098594),-85.1512214300217,10.76913998098594
516,46,57,132,235,POINT (-85.1512214300217 10.81300398098594),-85.1512214300217,10.81300398098594
517,48,56,130,234,POINT (-85.1512214300217 10.856867980985939),-85.1512214300217,10.856867980985939
518,47,58,126,231,POINT (-85.1512214300217 10.900731980985938),-85.1512214300217,10.900731980985938
519,42,56,125,223,POINT (-85.1512214300217 10.944595980985937),-85.1512214300217,10.944595980985937
520,38,55,119,212,POINT (-85.1512214300217 10.988459980985937),-85.1512214300217,10.988459980985937
521,28,52,116,196,POINT (-85.1512214300217 11.032323980985936),-85.1512214300217,11.032323980985936
522,19,15,98,132,POINT (-85.1152894300217 9.584811980985961),-85.1152894300217,9.584811980985961
523,19,33,100,152,POINT (-85.1152894300217 9.62867598098596),-85.1152894300217,9.62867598098596
524,19,33,100,152,POINT (-85.1152894300217 9.67253998098596),-85.1152894300217,9.67253998098596
525,19,32,101,152,POINT (-85.1152894300217 9.716403980985959),-85.1152894300217,9.716403980985959
526,18,32,101,151,POINT (-85.1152894300217 9.760267980985958),-85.1152894300217,9.760267980985958
527,18,31,101,150,POINT (-85.1152894300217 9.804131980985957),-85.1152894300217,9.804131980985957
528,17,31,101,149,POINT (-85.1152894300217 9.847995980985957),-85.1152894300217,9.847995980985957
529,17,32,101,150,POINT (-85.1152894300217 9.891859980985956),-85.1152894300217,9.891859980985956
530,17,33,101,151,POINT (-85.1152894300217 9.935723980985955),-85.1152894300217,9.935723980985955
531,0,7,36,43,POINT (-85.1152894300217 9.979587980985954),-85.1152894300217,9.979587980985954
532,0,4,26,30,POINT (-85.1152894300217 10.023451980985953),-85.1152894300217,10.023451980985953
533,0,6,26,32,POINT (-85.1152894300217 10.067315980985953),-85.1152894300217,10.067315980985953
534,0,6,26,32,POINT (-85.1152894300217 10.111179980985952),-85.1152894300217,10.111179980985952
535,0,5,26,31,POINT (-85.1152894300217 10.155043980985951),-85.1152894300217,10.155043980985951
536,23,39,110,172,POINT (-85.1152894300217 10.19890798098595),-85.1152894300217,10.19890798098595
537,23,41,110,174,POINT (-85.1152894300217 10.24277198098595),-85.1152894300217,10.24277198098595
538,23,45,111,179,POINT (-85.1152894300217 10.286635980985949),-85.1152894300217,10.286635980985949
539,24,47,112,183,POINT (-85.1152894300217 10.330499980985948),-85.1152894300217,10.330499980985948
540,23,53,114,190,POINT (-85.1152894300217 10.374363980985947),-85.1152894300217,10.374363980985947
541,23,56,114,193,POINT (-85.1152894300217 10.418227980985947),-85.1152894300217,10.418227980985947
542,25,58,114,197,POINT (-85.1152894300217 10.462091980985946),-85.1152894300217,10.462091980985946
543,24,58,114,196,POINT (-85.1152894300217 10.505955980985945),-85.1152894300217,10.505955980985945
544,27,59,117,203,POINT (-85.1152894300217 10.549819980985944),-85.1152894300217,10.549819980985944
545,30,62,123,215,POINT (-85.1152894300217 10.593683980985944),-85.1152894300217,10.593683980985944
546,34,57,127,218,POINT (-85.1152894300217 10.637547980985943),-85.1152894300217,10.637547980985943
547,35,58,129,222,POINT (-85.1152894300217 10.681411980985942),-85.1152894300217,10.681411980985942
548,34,52,131,217,POINT (-85.1152894300217 10.725275980985941),-85.1152894300217,10.725275980985941
549,36,51,131,218,POINT (-85.1152894300217 10.76913998098594),-85.1152894300217,10.76913998098594
550,49,60,130,239,POINT (-85.1152894300217 10.81300398098594),-85.1152894300217,10.81300398098594
551,46,60,128,234,POINT (-85.1152894300217 10.856867980985939),-85.1152894300217,10.856867980985939
552,47,58,127,232,POINT (-85.1152894300217 10.900731980985938),-85.1152894300217,10.900731980985938
553,42,59,123,224,POINT (-85.1152894300217 10.944595980985937),-85.1152894300217,10.944595980985937
554,36,56,118,210,POINT (-85.1152894300217 10.988459980985937),-85.1152894300217,10.988459980985937
555,25,54,113,192,POINT (-85.1152894300217 11.032323980985936),-85.1152894300217,11.032323980985936
556,19,14,98,131,POINT (-85.0793574300217 9.62867598098596),-85.0793574300217,9.62867598098596
557,19,32,100,151,POINT (-85.0793574300217 9.67253998098596),-85.0793574300217,9.67253998098596
558,19,32,101,152,POINT (-85.0793574300217 9.716403980985959),-85.0793574300217,9.716403980985959
559,18,32,101,151,POINT (-85.0793574300217 9.760267980985958),-85.0793574300217,9.760267980985958
560,18,32,101,151,POINT (-85.0793574300217 9.804131980985957),-85.0793574300217,9.804131980985957
561,18,32,101,151,POINT (-85.0793574300217 9.847995980985957),-85.0793574300217,9.847995980985957
562,18,32,101,151,POINT (-85.0793574300217 9.891859980985956),-85.0793574300217,9.891859980985956
563,18,33,100,151,POINT (-85.0793574300217 9.935723980985955),-85.0793574300217,9.935723980985955
564,0,5,1,6,POINT (-85.0793574300217 9.979587980985954),-85.0793574300217,9.979587980985954
565,0,6,26,32,POINT (-85.0793574300217 10.023451980985953),-85.0793574300217,10.023451980985953
566,0,6,26,32,POINT (-85.0793574300217 10.067315980985953),-85.0793574300217,10.067315980985953
567,0,6,26,32,POINT (-85.0793574300217 10.111179980985952),-85.0793574300217,10.111179980985952
568,0,7,26,33,POINT (-85.0793574300217 10.155043980985951),-85.0793574300217,10.155043980985951
569,23,40,110,173,POINT (-85.0793574300217 10.19890798098595),-85.0793574300217,10.19890798098595
570,23,41,109,173,POINT (-85.0793574300217 10.24277198098595),-85.0793574300217,10.24277198098595
571,23,45,112,180,POINT (-85.0793574300217 10.286635980985949),-85.0793574300217,10.286635980985949
572,24,50,115,189,POINT (-85.0793574300217 10.330499980985948),-85.0793574300217,10.330499980985948
573,23,55,114,192,POINT (-85.0793574300217 10.374363980985947),-85.0793574300217,10.374363980985947
574,24,59,114,197,POINT (-85.0793574300217 10.418227980985947),-85.0793574300217,10.418227980985947
575,27,56,114,197,POINT (-85.0793574300217 10.462091980985946),-85.0793574300217,10.462091980985946
576,28,57,117,202,POINT (-85.0793574300217 10.505955980985945),-85.0793574300217,10.505955980985945
577,30,63,121,214,POINT (-85.0793574300217 10.549819980985944),-85.0793574300217,10.549819980985944
578,35,62,125,222,POINT (-85.0793574300217 10.593683980985944),-85.0793574300217,10.593683980985944
579,37,60,126,223,POINT (-85.0793574300217 10.637547980985943),-85.0793574300217,10.637547980985943
580,41,56,129,226,POINT (-85.0793574300217 10.681411980985942),-85.0793574300217,10.681411980985942
581,43,52,129,224,POINT (-85.0793574300217 10.725275980985941),-85.0793574300217,10.725275980985941
582,40,56,132,228,POINT (-85.0793574300217 10.76913998098594),-85.0793574300217,10.76913998098594
583,48,58,131,237,POINT (-85.0793574300217 10.81300398098594),-85.0793574300217,10.81300398098594
584,46,60,131,237,POINT (-85.0793574300217 10.856867980985939),-85.0793574300217,10.856867980985939
585,45,58,125,228,POINT (-85.0793574300217 10.900731980985938),-85.0793574300217,10.900731980985938
586,39,55,124,218,POINT (-85.0793574300217 10.944595980985937),-85.0793574300217,10.944595980985937
587,33,54,117,204,POINT (-85.0793574300217 10.988459980985937),-85.0793574300217,10.988459980985937
588,19,30,99,148,POINT (-85.0434254300217 9.67253998098596),-85.0434254300217,9.67253998098596
589,19,32,101,152,POINT (-85.0434254300217 9.716403980985959),-85.0434254300217,9.716403980985959
590,18,32,101,151,POINT (-85.0434254300217 9.760267980985958),-85.0434254300217,9.760267980985958
591,18,32,101,151,POINT (-85.0434254300217 9.804131980985957),-85.0434254300217,9.804131980985957
592,18,32,101,151,POINT (-85.0434254300217 9.847995980985957),-85.0434254300217,9.847995980985957
593,18,32,100,150,POINT (-85.0434254300217 9.891859980985956),-85.0434254300217,9.891859980985956
594,18,33,100,151,POINT (-85.0434254300217 9.935723980985955),-85.0434254300217,9.935723980985955
595,0,4,26,30,POINT (-85.0434254300217 9.979587980985954),-85.0434254300217,9.979587980985954
596,0,6,26,32,POINT (-85.0434254300217 10.023451980985953),-85.0434254300217,10.023451980985953
597,0,6,26,32,POINT (-85.0434254300217 10.067315980985953),-85.0434254300217,10.067315980985953
598,0,7,26,33,POINT (-85.0434254300217 10.111179980985952),-85.0434254300217,10.111179980985952
599,24,40,108,172,POINT (-85.0434254300217 10.155043980985951),-85.0434254300217,10.155043980985951
600,23,41,108,172,POINT (-85.0434254300217 10.19890798098595),-85.0434254300217,10.19890798098595
601,23,43,111,177,POINT (-85.0434254300217 10.24277198098595),-85.0434254300217,10.24277198098595
602,24,49,114,187,POINT (-85.0434254300217 10.286635980985949),-85.0434254300217,10.286635980985949
603,24,53,116,193,POINT (-85.0434254300217 10.330499980985948),-85.0434254300217,10.330499980985948
604,24,59,115,198,POINT (-85.0434254300217 10.374363980985947),-85.0434254300217,10.374363980985947
605,28,58,116,202,POINT (-85.0434254300217 10.418227980985947),-85.0434254300217,10.418227980985947
606,29,58,116,203,POINT (-85.0434254300217 10.462091980985946),-85.0434254300217,10.462091980985946
607,34,58,120,212,POINT (-85.0434254300217 10.505955980985945),-85.0434254300217,10.505955980985945
608,37,62,123,222,POINT (-85.0434254300217 10.549819980985944),-85.0434254300217,10.549819980985944
609,40,64,125,229,POINT (-85.0434254300217 10.593683980985944),-85.0434254300217,10.593683980985944
610,42,60,126,228,POINT (-85.0434254300217 10.637547980985943),-85.0434254300217,10.637547980985943
611,45,57,128,230,POINT (-85.0434254300217 10.681411980985942),-85.0434254300217,10.681411980985942
612,45,53,128,226,POINT (-85.0434254300217 10.725275980985941),-85.0434254300217,10.725275980985941
613,46,54,135,235,POINT (-85.0434254300217 10.76913998098594),-85.0434254300217,10.76913998098594
614,48,54,132,234,POINT (-85.0434254300217 10.81300398098594),-85.0434254300217,10.81300398098594
615,47,54,130,231,POINT (-85.0434254300217 10.856867980985939),-85.0434254300217,10.856867980985939
616,45,55,127,227,POINT (-85.0434254300217 10.900731980985938),-85.0434254300217,10.900731980985938
617,38,55,124,217,POINT (-85.0434254300217 10.944595980985937),-85.0434254300217,10.944595980985937
618,28,53,117,198,POINT (-85.0434254300217 10.988459980985937),-85.0434254300217,10.988459980985937
619,0,7,26,33,POINT (-85.0074934300217 9.716403980985959),-85.0074934300217,9.716403980985959
620,18,31,101,150,POINT (-85.0074934300217 9.760267980985958),-85.0074934300217,9.760267980985958
621,18,31,101,150,POINT (-85.0074934300217 9.804131980985957),-85.0074934300217,9.804131980985957
622,18,32,100,150,POINT (-85.0074934300217 9.847995980985957),-85.0074934300217,9.847995980985957
623,18,33,100,151,POINT (-85.0074934300217 9.891859980985956),-85.0074934300217,9.891859980985956
624,0,7,35,42,POINT (-85.0074934300217 9.935723980985955),-85.0074934300217,9.935723980985955
625,0,6,26,32,POINT (-85.0074934300217 9.979587980985954),-85.0074934300217,9.979587980985954
626,0,6,26,32,POINT (-85.0074934300217 10.023451980985953),-85.0074934300217,10.023451980985953
627,0,6,26,32,POINT (-85.0074934300217 10.067315980985953),-85.0074934300217,10.067315980985953
628,23,38,97,158,POINT (-85.0074934300217 10.111179980985952),-85.0074934300217,10.111179980985952
629,24,42,108,174,POINT (-85.0074934300217 10.155043980985951),-85.0074934300217,10.155043980985951
630,24,41,110,175,POINT (-85.0074934300217 10.19890798098595),-85.0074934300217,10.19890798098595
631,25,46,115,186,POINT (-85.0074934300217 10.24277198098595),-85.0074934300217,10.24277198098595
632,25,51,117,193,POINT (-85.0074934300217 10.286635980985949),-85.0074934300217,10.286635980985949
633,26,54,116,196,POINT (-85.0074934300217 10.330499980985948),-85.0074934300217,10.330499980985948
634,27,58,118,203,POINT (-85.0074934300217 10.374363980985947),-85.0074934300217,10.374363980985947
635,32,58,118,208,POINT (-85.0074934300217 10.418227980985947),-85.0074934300217,10.418227980985947
636,34,61,122,217,POINT (-85.0074934300217 10.462091980985946),-85.0074934300217,10.462091980985946
637,41,63,123,227,POINT (-85.0074934300217 10.505955980985945),-85.0074934300217,10.505955980985945
638,42,68,127,237,POINT (-85.0074934300217 10.549819980985944),-85.0074934300217,10.549819980985944
639,45,56,127,228,POINT (-85.0074934300217 10.593683980985944),-85.0074934300217,10.593683980985944
640,45,56,128,229,POINT (-85.0074934300217 10.637547980985943),-85.0074934300217,10.637547980985943
641,39,50,126,215,POINT (-85.0074934300217 10.681411980985942),-85.0074934300217,10.681411980985942
642,44,56,130,230,POINT (-85.0074934300217 10.725275980985941),-85.0074934300217,10.725275980985941
643,46,52,134,232,POINT (-85.0074934300217 10.76913998098594),-85.0074934300217,10.76913998098594
644,47,52,133,232,POINT (-85.0074934300217 10.81300398098594),-85.0074934300217,10.81300398098594
645,46,52,130,228,POINT (-85.0074934300217 10.856867980985939),-85.0074934300217,10.856867980985939
646,43,55,127,225,POINT (-85.0074934300217 10.900731980985938),-85.0074934300217,10.900731980985938
647,37,54,124,215,POINT (-85.0074934300217 10.944595980985937),-85.0074934300217,10.944595980985937
648,26,51,116,193,POINT (-85.0074934300217 10.988459980985937),-85.0074934300217,10.988459980985937
649,18,31,100,149,POINT (-84.9715614300217 9.760267980985958),-84.9715614300217,9.760267980985958
650,18,31,100,149,POINT (-84.9715614300217 9.804131980985957),-84.9715614300217,9.804131980985957
651,18,32,100,150,POINT (-84.9715614300217 9.847995980985957),-84.9715614300217,9.847995980985957
652,18,33,100,151,POINT (-84.9715614300217 9.891859980985956),-84.9715614300217,9.891859980985956
653,2,9,35,46,POINT (-84.9715614300217 9.935723980985955),-84.9715614300217,9.935723980985955
654,0,8,0,8,POINT (-84.9715614300217 9.979587980985954),-84.9715614300217,9.979587980985954
655,0,6,26,32,POINT (-84.9715614300217 10.023451980985953),-84.9715614300217,10.023451980985953
656,0,6,26,32,POINT (-84.9715614300217 10.067315980985953),-84.9715614300217,10.067315980985953
657,25,41,108,174,POINT (-84.9715614300217 10.111179980985952),-84.9715614300217,10.111179980985952
658,26,42,109,177,POINT (-84.9715614300217 10.155043980985951),-84.9715614300217,10.155043980985951
659,25,45,112,182,POINT (-84.9715614300217 10.19890798098595),-84.9715614300217,10.19890798098595
660,26,52,115,193,POINT (-84.9715614300217 10.24277198098595),-84.9715614300217,10.24277198098595
661,26,52,119,197,POINT (-84.9715614300217 10.286635980985949),-84.9715614300217,10.286635980985949
662,27,54,119,200,POINT (-84.9715614300217 10.330499980985948),-84.9715614300217,10.330499980985948
663,30,59,118,207,POINT (-84.9715614300217 10.374363980985947),-84.9715614300217,10.374363980985947
664,38,61,122,221,POINT (-84.9715614300217 10.418227980985947),-84.9715614300217,10.418227980985947
665,44,64,121,229,POINT (-84.9715614300217 10.462091980985946),-84.9715614300217,10.462091980985946
666,45,69,124,238,POINT (-84.9715614300217 10.505955980985945),-84.9715614300217,10.505955980985945
667,46,63,128,237,POINT (-84.9715614300217 10.549819980985944),-84.9715614300217,10.549819980985944
668,41,56,128,225,POINT (-84.9715614300217 10.593683980985944),-84.9715614300217,10.593683980985944
669,50,53,128,231,POINT (-84.9715614300217 10.637547980985943),-84.9715614300217,10.637547980985943
670,47,53,129,229,POINT (-84.9715614300217 10.681411980985942),-84.9715614300217,10.681411980985942
671,42,56,133,231,POINT (-84.9715614300217 10.725275980985941),-84.9715614300217,10.725275980985941
672,47,50,134,231,POINT (-84.9715614300217 10.76913998098594),-84.9715614300217,10.76913998098594
673,48,51,133,232,POINT (-84.9715614300217 10.81300398098594),-84.9715614300217,10.81300398098594
674,45,53,130,228,POINT (-84.9715614300217 10.856867980985939),-84.9715614300217,10.856867980985939
675,41,55,127,223,POINT (-84.9715614300217 10.900731980985938),-84.9715614300217,10.900731980985938
676,33,53,122,208,POINT (-84.9715614300217 10.944595980985937),-84.9715614300217,10.944595980985937
677,18,31,100,149,POINT (-84.93562943002169 9.804131980985957),-84.93562943002169,9.804131980985957
678,18,33,99,150,POINT (-84.93562943002169 9.847995980985957),-84.93562943002169,9.847995980985957
679,18,27,98,143,POINT (-84.93562943002169 9.891859980985956),-84.93562943002169,9.891859980985956
680,26,41,109,176,POINT (-84.93562943002169 10.067315980985953),-84.93562943002169,10.067315980985953
681,26,43,110,179,POINT (-84.93562943002169 10.111179980985952),-84.93562943002169,10.111179980985952
682,26,46,113,185,POINT (-84.93562943002169 10.155043980985951),-84.93562943002169,10.155043980985951
683,26,52,115,193,POINT (-84.93562943002169 10.19890798098595),-84.93562943002169,10.19890798098595
684,25,56,118,199,POINT (-84.93562943002169 10.24277198098595),-84.93562943002169,10.24277198098595
685,26,56,121,203,POINT (-84.93562943002169 10.286635980985949),-84.93562943002169,10.286635980985949
686,28,58,121,207,POINT (-84.93562943002169 10.330499980985948),-84.93562943002169,10.330499980985948
687,36,57,121,214,POINT (-84.93562943002169 10.374363980985947),-84.93562943002169,10.374363980985947
688,41,59,123,223,POINT (-84.93562943002169 10.418227980985947),-84.93562943002169,10.418227980985947
689,47,61,124,232,POINT (-84.93562943002169 10.462091980985946),-84.93562943002169,10.462091980985946
690,51,63,126,240,POINT (-84.93562943002169 10.505955980985945),-84.93562943002169,10.505955980985945
691,49,60,127,236,POINT (-84.93562943002169 10.549819980985944),-84.93562943002169,10.549819980985944
692,52,52,128,232,POINT (-84.93562943002169 10.593683980985944),-84.93562943002169,10.593683980985944
693,51,50,130,231,POINT (-84.93562943002169 10.637547980985943),-84.93562943002169,10.637547980985943
694,44,53,132,229,POINT (-84.93562943002169 10.681411980985942),-84.93562943002169,10.681411980985942
695,46,53,134,233,POINT (-84.93562943002169 10.725275980985941),-84.93562943002169,10.725275980985941
696,48,48,135,231,POINT (-84.93562943002169 10.76913998098594),-84.93562943002169,10.76913998098594
697,47,52,134,233,POINT (-84.93562943002169 10.81300398098594),-84.93562943002169,10.81300398098594
698,44,53,131,228,POINT (-84.93562943002169 10.856867980985939),-84.93562943002169,10.856867980985939
699,38,55,128,221,POINT (-84.93562943002169 10.900731980985938),-84.93562943002169,10.900731980985938
700,31,52,120,203,POINT (-84.93562943002169 10.944595980985937),-84.93562943002169,10.944595980985937
701,26,45,109,180,POINT (-84.89969743002169 10.067315980985953),-84.89969743002169,10.067315980985953
702,26,49,111,186,POINT (-84.89969743002169 10.111179980985952),-84.89969743002169,10.111179980985952
703,27,53,114,194,POINT (-84.89969743002169 10.155043980985951),-84.89969743002169,10.155043980985951
704,25,53,118,196,POINT (-84.89969743002169 10.19890798098595),-84.89969743002169,10.19890798098595
705,26,56,120,202,POINT (-84.89969743002169 10.24277198098595),-84.89969743002169,10.24277198098595
706,28,60,122,210,POINT (-84.89969743002169 10.286635980985949),-84.89969743002169,10.286635980985949
707,30,59,123,212,POINT (-84.89969743002169 10.330499980985948),-84.89969743002169,10.330499980985948
708,39,59,126,224,POINT (-84.89969743002169 10.374363980985947),-84.89969743002169,10.374363980985947
709,43,61,127,231,POINT (-84.89969743002169 10.418227980985947),-84.89969743002169,10.418227980985947
710,52,60,128,240,POINT (-84.89969743002169 10.462091980985946),-84.89969743002169,10.462091980985946
711,52,64,123,239,POINT (-84.89969743002169 10.505955980985945),-84.89969743002169,10.505955980985945
712,55,55,127,237,POINT (-84.89969743002169 10.549819980985944),-84.89969743002169,10.549819980985944
713,53,52,128,233,POINT (-84.89969743002169 10.593683980985944),-84.89969743002169,10.593683980985944
714,48,53,131,232,POINT (-84.89969743002169 10.637547980985943),-84.89969743002169,10.637547980985943
715,46,53,133,232,POINT (-84.89969743002169 10.681411980985942),-84.89969743002169,10.681411980985942
716,49,54,134,237,POINT (-84.89969743002169 10.725275980985941),-84.89969743002169,10.725275980985941
717,47,55,136,238,POINT (-84.89969743002169 10.76913998098594),-84.89969743002169,10.76913998098594
718,46,53,134,233,POINT (-84.89969743002169 10.81300398098594),-84.89969743002169,10.81300398098594
719,41,54,131,226,POINT (-84.89969743002169 10.856867980985939),-84.89969743002169,10.856867980985939
720,38,55,127,220,POINT (-84.89969743002169 10.900731980985938),-84.89969743002169,10.900731980985938
721,31,53,123,207,POINT (-84.89969743002169 10.944595980985937),-84.89969743002169,10.944595980985937
722,26,50,109,185,POINT (-84.86376543002169 10.023451980985953),-84.86376543002169,10.023451980985953
723,26,49,110,185,POINT (-84.86376543002169 10.067315980985953),-84.86376543002169,10.067315980985953
724,26,49,114,189,POINT (-84.86376543002169 10.111179980985952),-84.86376543002169,10.111179980985952
725,26,54,116,196,POINT (-84.86376543002169 10.155043980985951),-84.86376543002169,10.155043980985951
726,26,56,118,200,POINT (-84.86376543002169 10.19890798098595),-84.86376543002169,10.19890798098595
727,27,61,123,211,POINT (-84.86376543002169 10.24277198098595),-84.86376543002169,10.24277198098595
728,31,61,124,216,POINT (-84.86376543002169 10.286635980985949),-84.86376543002169,10.286635980985949
729,35,57,129,221,POINT (-84.86376543002169 10.330499980985948),-84.86376543002169,10.330499980985948
730,37,56,129,222,POINT (-84.86376543002169 10.374363980985947),-84.86376543002169,10.374363980985947
731,44,57,132,233,POINT (-84.86376543002169 10.418227980985947),-84.86376543002169,10.418227980985947
732,52,59,129,240,POINT (-84.86376543002169 10.462091980985946),-84.86376543002169,10.462091980985946
733,53,58,123,234,POINT (-84.86376543002169 10.505955980985945),-84.86376543002169,10.505955980985945
734,57,55,129,241,POINT (-84.86376543002169 10.549819980985944),-84.86376543002169,10.549819980985944
735,53,52,130,235,POINT (-84.86376543002169 10.593683980985944),-84.86376543002169,10.593683980985944
736,50,50,130,230,POINT (-84.86376543002169 10.637547980985943),-84.86376543002169,10.637547980985943
737,49,57,134,240,POINT (-84.86376543002169 10.681411980985942),-84.86376543002169,10.681411980985942
738,49,53,134,236,POINT (-84.86376543002169 10.725275980985941),-84.86376543002169,10.725275980985941
739,47,54,136,237,POINT (-84.86376543002169 10.76913998098594),-84.86376543002169,10.76913998098594
740,44,53,134,231,POINT (-84.86376543002169 10.81300398098594),-84.86376543002169,10.81300398098594
741,41,53,132,226,POINT (-84.86376543002169 10.856867980985939),-84.86376543002169,10.856867980985939
742,39,53,128,220,POINT (-84.86376543002169 10.900731980985938),-84.86376543002169,10.900731980985938
743,33,52,123,208,POINT (-84.86376543002169 10.944595980985937),-84.86376543002169,10.944595980985937
744,27,49,108,184,POINT (-84.82783343002168 10.023451980985953),-84.82783343002168,10.023451980985953
745,26,51,113,190,POINT (-84.82783343002168 10.067315980985953),-84.82783343002168,10.067315980985953
746,27,55,115,197,POINT (-84.82783343002168 10.111179980985952),-84.82783343002168,10.111179980985952
747,26,58,118,202,POINT (-84.82783343002168 10.155043980985951),-84.82783343002168,10.155043980985951
748,26,60,121,207,POINT (-84.82783343002168 10.19890798098595),-84.82783343002168,10.19890798098595
749,31,63,124,218,POINT (-84.82783343002168 10.24277198098595),-84.82783343002168,10.24277198098595
750,36,65,129,230,POINT (-84.82783343002168 10.286635980985949),-84.82783343002168,10.286635980985949
751,39,63,130,232,POINT (-84.82783343002168 10.330499980985948),-84.82783343002168,10.330499980985948
752,42,55,133,230,POINT (-84.82783343002168 10.374363980985947),-84.82783343002168,10.374363980985947
753,47,58,130,235,POINT (-84.82783343002168 10.418227980985947),-84.82783343002168,10.418227980985947
754,52,62,128,242,POINT (-84.82783343002168 10.462091980985946),-84.82783343002168,10.462091980985946
755,56,61,126,243,POINT (-84.82783343002168 10.505955980985945),-84.82783343002168,10.505955980985945
756,55,55,130,240,POINT (-84.82783343002168 10.549819980985944),-84.82783343002168,10.549819980985944
757,51,56,132,239,POINT (-84.82783343002168 10.593683980985944),-84.82783343002168,10.593683980985944
758,50,55,133,238,POINT (-84.82783343002168 10.637547980985943),-84.82783343002168,10.637547980985943
759,48,52,134,234,POINT (-84.82783343002168 10.681411980985942),-84.82783343002168,10.681411980985942
760,48,53,135,236,POINT (-84.82783343002168 10.725275980985941),-84.82783343002168,10.725275980985941
761,45,51,134,230,POINT (-84.82783343002168 10.76913998098594),-84.82783343002168,10.76913998098594
762,44,51,133,228,POINT (-84.82783343002168 10.81300398098594),-84.82783343002168,10.81300398098594
763,41,48,132,221,POINT (-84.82783343002168 10.856867980985939),-84.82783343002168,10.856867980985939
764,39,50,129,218,POINT (-84.82783343002168 10.900731980985938),-84.82783343002168,10.900731980985938
765,33,49,122,204,POINT (-84.82783343002168 10.944595980985937),-84.82783343002168,10.944595980985937
766,30,50,120,200,POINT (-84.82783343002168 10.988459980985937),-84.82783343002168,10.988459980985937
767,28,39,95,162,POINT (-84.79190143002168 9.979587980985954),-84.79190143002168,9.979587980985954
768,28,50,109,187,POINT (-84.79190143002168 10.023451980985953),-84.79190143002168,10.023451980985953
769,29,52,112,193,POINT (-84.79190143002168 10.067315980985953),-84.79190143002168,10.067315980985953
770,28,56,117,201,POINT (-84.79190143002168 10.111179980985952),-84.79190143002168,10.111179980985952
771,28,59,118,205,POINT (-84.79190143002168 10.155043980985951),-84.79190143002168,10.155043980985951
772,32,62,121,215,POINT (-84.79190143002168 10.19890798098595),-84.79190143002168,10.19890798098595
773,35,59,129,223,POINT (-84.79190143002168 10.24277198098595),-84.79190143002168,10.24277198098595
774,46,60,131,237,POINT (-84.79190143002168 10.286635980985949),-84.79190143002168,10.286635980985949
775,52,54,132,238,POINT (-84.79190143002168 10.330499980985948),-84.79190143002168,10.330499980985948
776,49,59,132,240,POINT (-84.79190143002168 10.374363980985947),-84.79190143002168,10.374363980985947
777,51,63,131,245,POINT (-84.79190143002168 10.418227980985947),-84.79190143002168,10.418227980985947
778,54,70,125,249,POINT (-84.79190143002168 10.462091980985946),-84.79190143002168,10.462091980985946
779,56,64,127,247,POINT (-84.79190143002168 10.505955980985945),-84.79190143002168,10.505955980985945
780,52,57,130,239,POINT (-84.79190143002168 10.549819980985944),-84.79190143002168,10.549819980985944
781,49,55,130,234,POINT (-84.79190143002168 10.593683980985944),-84.79190143002168,10.593683980985944
782,50,53,134,237,POINT (-84.79190143002168 10.637547980985943),-84.79190143002168,10.637547980985943
783,48,52,134,234,POINT (-84.79190143002168 10.681411980985942),-84.79190143002168,10.681411980985942
784,45,49,135,229,POINT (-84.79190143002168 10.725275980985941),-84.79190143002168,10.725275980985941
785,45,50,134,229,POINT (-84.79190143002168 10.76913998098594),-84.79190143002168,10.76913998098594
786,43,50,133,226,POINT (-84.79190143002168 10.81300398098594),-84.79190143002168,10.81300398098594
787,41,50,130,221,POINT (-84.79190143002168 10.856867980985939),-84.79190143002168,10.856867980985939
788,39,51,127,217,POINT (-84.79190143002168 10.900731980985938),-84.79190143002168,10.900731980985938
789,36,49,123,208,POINT (-84.79190143002168 10.944595980985937),-84.79190143002168,10.944595980985937
790,32,50,120,202,POINT (-84.79190143002168 10.988459980985937),-84.79190143002168,10.988459980985937
791,31,49,108,188,POINT (-84.75596943002168 9.979587980985954),-84.75596943002168,9.979587980985954
792,30,53,112,195,POINT (-84.75596943002168 10.023451980985953),-84.75596943002168,10.023451980985953
793,28,57,113,198,POINT (-84.75596943002168 10.067315980985953),-84.75596943002168,10.067315980985953
794,31,56,119,206,POINT (-84.75596943002168 10.111179980985952),-84.75596943002168,10.111179980985952
795,32,57,122,211,POINT (-84.75596943002168 10.155043980985951),-84.75596943002168,10.155043980985951
796,31,60,128,219,POINT (-84.75596943002168 10.19890798098595),-84.75596943002168,10.19890798098595
797,39,62,133,234,POINT (-84.75596943002168 10.24277198098595),-84.75596943002168,10.24277198098595
798,51,59,134,244,POINT (-84.75596943002168 10.286635980985949),-84.75596943002168,10.286635980985949
799,52,55,132,239,POINT (-84.75596943002168 10.330499980985948),-84.75596943002168,10.330499980985948
800,52,60,134,246,POINT (-84.75596943002168 10.374363980985947),-84.75596943002168,10.374363980985947
801,55,69,130,254,POINT (-84.75596943002168 10.418227980985947),-84.75596943002168,10.418227980985947
802,56,65,126,247,POINT (-84.75596943002168 10.462091980985946),-84.75596943002168,10.462091980985946
803,52,62,128,242,POINT (-84.75596943002168 10.505955980985945),-84.75596943002168,10.505955980985945
804,51,59,131,241,POINT (-84.75596943002168 10.549819980985944),-84.75596943002168,10.549819980985944
805,51,55,132,238,POINT (-84.75596943002168 10.593683980985944),-84.75596943002168,10.593683980985944
806,49,52,133,234,POINT (-84.75596943002168 10.637547980985943),-84.75596943002168,10.637547980985943
807,47,49,133,229,POINT (-84.75596943002168 10.681411980985942),-84.75596943002168,10.681411980985942
808,45,48,135,228,POINT (-84.75596943002168 10.725275980985941),-84.75596943002168,10.725275980985941
809,45,51,135,231,POINT (-84.75596943002168 10.76913998098594),-84.75596943002168,10.76913998098594
810,44,52,134,230,POINT (-84.75596943002168 10.81300398098594),-84.75596943002168,10.81300398098594
811,39,52,130,221,POINT (-84.75596943002168 10.856867980985939),-84.75596943002168,10.856867980985939
812,39,51,128,218,POINT (-84.75596943002168 10.900731980985938),-84.75596943002168,10.900731980985938
813,37,50,125,212,POINT (-84.75596943002168 10.944595980985937),-84.75596943002168,10.944595980985937
814,34,50,123,207,POINT (-84.75596943002168 10.988459980985937),-84.75596943002168,10.988459980985937
815,30,50,121,201,POINT (-84.75596943002168 11.032323980985936),-84.75596943002168,11.032323980985936
816,31,27,107,165,POINT (-84.72003743002168 9.935723980985955),-84.72003743002168,9.935723980985955
817,32,54,110,196,POINT (-84.72003743002168 9.979587980985954),-84.72003743002168,9.979587980985954
818,32,55,112,199,POINT (-84.72003743002168 10.023451980985953),-84.72003743002168,10.023451980985953
819,30,56,117,203,POINT (-84.72003743002168 10.067315980985953),-84.72003743002168,10.067315980985953
820,32,56,121,209,POINT (-84.72003743002168 10.111179980985952),-84.72003743002168,10.111179980985952
821,33,60,127,220,POINT (-84.72003743002168 10.155043980985951),-84.72003743002168,10.155043980985951
822,33,60,132,225,POINT (-84.72003743002168 10.19890798098595),-84.72003743002168,10.19890798098595
823,37,60,134,231,POINT (-84.72003743002168 10.24277198098595),-84.72003743002168,10.24277198098595
824,50,55,134,239,POINT (-84.72003743002168 10.286635980985949),-84.72003743002168,10.286635980985949
825,52,53,133,238,POINT (-84.72003743002168 10.330499980985948),-84.72003743002168,10.330499980985948
826,56,62,131,249,POINT (-84.72003743002168 10.374363980985947),-84.72003743002168,10.374363980985947
827,54,68,129,251,POINT (-84.72003743002168 10.418227980985947),-84.72003743002168,10.418227980985947
828,54,63,127,244,POINT (-84.72003743002168 10.462091980985946),-84.72003743002168,10.462091980985946
829,51,63,127,241,POINT (-84.72003743002168 10.505955980985945),-84.72003743002168,10.505955980985945
830,50,59,130,239,POINT (-84.72003743002168 10.549819980985944),-84.72003743002168,10.549819980985944
831,50,58,135,243,POINT (-84.72003743002168 10.593683980985944),-84.72003743002168,10.593683980985944
832,47,51,134,232,POINT (-84.72003743002168 10.637547980985943),-84.72003743002168,10.637547980985943
833,46,51,136,233,POINT (-84.72003743002168 10.681411980985942),-84.72003743002168,10.681411980985942
834,45,53,136,234,POINT (-84.72003743002168 10.725275980985941),-84.72003743002168,10.725275980985941
835,43,52,134,229,POINT (-84.72003743002168 10.76913998098594),-84.72003743002168,10.76913998098594
836,43,53,133,229,POINT (-84.72003743002168 10.81300398098594),-84.72003743002168,10.81300398098594
837,39,50,131,220,POINT (-84.72003743002168 10.856867980985939),-84.72003743002168,10.856867980985939
838,39,51,130,220,POINT (-84.72003743002168 10.900731980985938),-84.72003743002168,10.900731980985938
839,37,53,129,219,POINT (-84.72003743002168 10.944595980985937),-84.72003743002168,10.944595980985937
840,36,52,126,214,POINT (-84.72003743002168 10.988459980985937),-84.72003743002168,10.988459980985937
841,34,52,123,209,POINT (-84.72003743002168 11.032323980985936),-84.72003743002168,11.032323980985936
842,0,4,26,30,POINT (-84.68410543002167 9.804131980985957),-84.68410543002167,9.804131980985957
843,29,11,106,146,POINT (-84.68410543002167 9.847995980985957),-84.68410543002167,9.847995980985957
844,31,53,107,191,POINT (-84.68410543002167 9.891859980985956),-84.68410543002167,9.891859980985956
845,31,54,110,195,POINT (-84.68410543002167 9.935723980985955),-84.68410543002167,9.935723980985955
846,33,55,113,201,POINT (-84.68410543002167 9.979587980985954),-84.68410543002167,9.979587980985954
847,33,61,116,210,POINT (-84.68410543002167 10.023451980985953),-84.68410543002167,10.023451980985953
848,30,58,120,208,POINT (-84.68410543002167 10.067315980985953),-84.68410543002167,10.067315980985953
849,34,56,125,215,POINT (-84.68410543002167 10.111179980985952),-84.68410543002167,10.111179980985952
850,32,53,130,215,POINT (-84.68410543002167 10.155043980985951),-84.68410543002167,10.155043980985951
851,32,59,134,225,POINT (-84.68410543002167 10.19890798098595),-84.68410543002167,10.19890798098595
852,40,56,135,231,POINT (-84.68410543002167 10.24277198098595),-84.68410543002167,10.24277198098595
853,48,52,134,234,POINT (-84.68410543002167 10.286635980985949),-84.68410543002167,10.286635980985949
854,51,60,133,244,POINT (-84.68410543002167 10.330499980985948),-84.68410543002167,10.330499980985948
855,54,65,128,247,POINT (-84.68410543002167 10.374363980985947),-84.68410543002167,10.374363980985947
856,55,68,127,250,POINT (-84.68410543002167 10.418227980985947),-84.68410543002167,10.418227980985947
857,53,64,128,245,POINT (-84.68410543002167 10.462091980985946),-84.68410543002167,10.462091980985946
858,51,66,127,244,POINT (-84.68410543002167 10.505955980985945),-84.68410543002167,10.505955980985945
859,50,63,131,244,POINT (-84.68410543002167 10.549819980985944),-84.68410543002167,10.549819980985944
860,51,59,135,245,POINT (-84.68410543002167 10.593683980985944),-84.68410543002167,10.593683980985944
861,47,54,134,235,POINT (-84.68410543002167 10.637547980985943),-84.68410543002167,10.637547980985943
862,46,51,137,234,POINT (-84.68410543002167 10.681411980985942),-84.68410543002167,10.681411980985942
863,44,52,134,230,POINT (-84.68410543002167 10.725275980985941),-84.68410543002167,10.725275980985941
864,44,50,134,228,POINT (-84.68410543002167 10.76913998098594),-84.68410543002167,10.76913998098594
865,44,51,132,227,POINT (-84.68410543002167 10.81300398098594),-84.68410543002167,10.81300398098594
866,40,50,132,222,POINT (-84.68410543002167 10.856867980985939),-84.68410543002167,10.856867980985939
867,39,52,130,221,POINT (-84.68410543002167 10.900731980985938),-84.68410543002167,10.900731980985938
868,38,54,130,222,POINT (-84.68410543002167 10.944595980985937),-84.68410543002167,10.944595980985937
869,37,53,128,218,POINT (-84.68410543002167 10.988459980985937),-84.68410543002167,10.988459980985937
870,34,55,125,214,POINT (-84.68410543002167 11.032323980985936),-84.68410543002167,11.032323980985936
871,30,57,125,212,POINT (-84.68410543002167 11.076187980985935),-84.68410543002167,11.076187980985935
872,41,61,109,211,POINT (-84.64817343002167 9.62867598098596),-84.64817343002167,9.62867598098596
873,41,60,109,210,POINT (-84.64817343002167 9.67253998098596),-84.64817343002167,9.67253998098596
874,41,62,107,210,POINT (-84.64817343002167 9.716403980985959),-84.64817343002167,9.716403980985959
875,1,4,26,31,POINT (-84.64817343002167 9.760267980985958),-84.64817343002167,9.760267980985958
876,34,30,106,170,POINT (-84.64817343002167 9.804131980985957),-84.64817343002167,9.804131980985957
877,33,60,106,199,POINT (-84.64817343002167 9.847995980985957),-84.64817343002167,9.847995980985957
878,32,59,108,199,POINT (-84.64817343002167 9.891859980985956),-84.64817343002167,9.891859980985956
879,33,59,112,204,POINT (-84.64817343002167 9.935723980985955),-84.64817343002167,9.935723980985955
880,32,61,115,208,POINT (-84.64817343002167 9.979587980985954),-84.64817343002167,9.979587980985954
881,31,63,118,212,POINT (-84.64817343002167 10.023451980985953),-84.64817343002167,10.023451980985953
882,31,58,123,212,POINT (-84.64817343002167 10.067315980985953),-84.64817343002167,10.067315980985953
883,31,60,128,219,POINT (-84.64817343002167 10.111179980985952),-84.64817343002167,10.111179980985952
884,33,60,132,225,POINT (-84.64817343002167 10.155043980985951),-84.64817343002167,10.155043980985951
885,39,60,135,234,POINT (-84.64817343002167 10.19890798098595),-84.64817343002167,10.19890798098595
886,44,54,134,232,POINT (-84.64817343002167 10.24277198098595),-84.64817343002167,10.24277198098595
887,45,53,133,231,POINT (-84.64817343002167 10.286635980985949),-84.64817343002167,10.286635980985949
888,48,58,129,235,POINT (-84.64817343002167 10.330499980985948),-84.64817343002167,10.330499980985948
889,52,68,126,246,POINT (-84.64817343002167 10.374363980985947),-84.64817343002167,10.374363980985947
890,52,66,128,246,POINT (-84.64817343002167 10.418227980985947),-84.64817343002167,10.418227980985947
891,54,65,129,248,POINT (-84.64817343002167 10.462091980985946),-84.64817343002167,10.462091980985946
892,50,66,130,246,POINT (-84.64817343002167 10.505955980985945),-84.64817343002167,10.505955980985945
893,50,63,135,248,POINT (-84.64817343002167 10.549819980985944),-84.64817343002167,10.549819980985944
894,50,58,135,243,POINT (-84.64817343002167 10.593683980985944),-84.64817343002167,10.593683980985944
895,46,55,137,238,POINT (-84.64817343002167 10.637547980985943),-84.64817343002167,10.637547980985943
896,44,55,136,235,POINT (-84.64817343002167 10.681411980985942),-84.64817343002167,10.681411980985942
897,44,51,136,231,POINT (-84.64817343002167 10.725275980985941),-84.64817343002167,10.725275980985941
898,42,52,136,230,POINT (-84.64817343002167 10.76913998098594),-84.64817343002167,10.76913998098594
899,42,51,134,227,POINT (-84.64817343002167 10.81300398098594),-84.64817343002167,10.81300398098594
900,41,53,133,227,POINT (-84.64817343002167 10.856867980985939),-84.64817343002167,10.856867980985939
901,38,54,132,224,POINT (-84.64817343002167 10.900731980985938),-84.64817343002167,10.900731980985938
902,37,58,131,226,POINT (-84.64817343002167 10.944595980985937),-84.64817343002167,10.944595980985937
903,36,57,129,222,POINT (-84.64817343002167 10.988459980985937),-84.64817343002167,10.988459980985937
904,35,58,127,220,POINT (-84.64817343002167 11.032323980985936),-84.64817343002167,11.032323980985936
905,41,63,109,213,POINT (-84.61224143002167 9.62867598098596),-84.61224143002167,9.62867598098596
906,42,63,110,215,POINT (-84.61224143002167 9.67253998098596),-84.61224143002167,9.67253998098596
907,43,65,111,219,POINT (-84.61224143002167 9.716403980985959),-84.61224143002167,9.716403980985959
908,42,63,110,215,POINT (-84.61224143002167 9.760267980985958),-84.61224143002167,9.760267980985958
909,36,63,108,207,POINT (-84.61224143002167 9.804131980985957),-84.61224143002167,9.804131980985957
910,35,65,108,208,POINT (-84.61224143002167 9.847995980985957),-84.61224143002167,9.847995980985957
911,33,63,113,209,POINT (-84.61224143002167 9.891859980985956),-84.61224143002167,9.891859980985956
912,31,64,115,210,POINT (-84.61224143002167 9.935723980985955),-84.61224143002167,9.935723980985955
913,31,64,119,214,POINT (-84.61224143002167 9.979587980985954),-84.61224143002167,9.979587980985954
914,30,61,121,212,POINT (-84.61224143002167 10.023451980985953),-84.61224143002167,10.023451980985953
915,29,57,124,210,POINT (-84.61224143002167 10.067315980985953),-84.61224143002167,10.067315980985953
916,32,58,132,222,POINT (-84.61224143002167 10.111179980985952),-84.61224143002167,10.111179980985952
917,35,61,133,229,POINT (-84.61224143002167 10.155043980985951),-84.61224143002167,10.155043980985951
918,40,60,134,234,POINT (-84.61224143002167 10.19890798098595),-84.61224143002167,10.19890798098595
919,45,60,134,239,POINT (-84.61224143002167 10.24277198098595),-84.61224143002167,10.24277198098595
920,45,58,132,235,POINT (-84.61224143002167 10.286635980985949),-84.61224143002167,10.286635980985949
921,43,66,128,237,POINT (-84.61224143002167 10.330499980985948),-84.61224143002167,10.330499980985948
922,50,70,128,248,POINT (-84.61224143002167 10.374363980985947),-84.61224143002167,10.374363980985947
923,52,69,128,249,POINT (-84.61224143002167 10.418227980985947),-84.61224143002167,10.418227980985947
924,53,68,131,252,POINT (-84.61224143002167 10.462091980985946),-84.61224143002167,10.462091980985946
925,49,66,132,247,POINT (-84.61224143002167 10.505955980985945),-84.61224143002167,10.505955980985945
926,51,62,136,249,POINT (-84.61224143002167 10.549819980985944),-84.61224143002167,10.549819980985944
927,50,58,135,243,POINT (-84.61224143002167 10.593683980985944),-84.61224143002167,10.593683980985944
928,44,57,138,239,POINT (-84.61224143002167 10.637547980985943),-84.61224143002167,10.637547980985943
929,43,58,139,240,POINT (-84.61224143002167 10.681411980985942),-84.61224143002167,10.681411980985942
930,43,57,137,237,POINT (-84.61224143002167 10.725275980985941),-84.61224143002167,10.725275980985941
931,42,55,138,235,POINT (-84.61224143002167 10.76913998098594),-84.61224143002167,10.76913998098594
932,42,54,136,232,POINT (-84.61224143002167 10.81300398098594),-84.61224143002167,10.81300398098594
933,41,55,134,230,POINT (-84.61224143002167 10.856867980985939),-84.61224143002167,10.856867980985939
934,39,59,132,230,POINT (-84.61224143002167 10.900731980985938),-84.61224143002167,10.900731980985938
935,38,61,131,230,POINT (-84.61224143002167 10.944595980985937),-84.61224143002167,10.944595980985937
936,37,61,130,228,POINT (-84.61224143002167 10.988459980985937),-84.61224143002167,10.988459980985937
937,37,62,128,227,POINT (-84.61224143002167 11.032323980985936),-84.61224143002167,11.032323980985936
938,42,66,110,218,POINT (-84.57630943002167 9.62867598098596),-84.57630943002167,9.62867598098596
939,44,66,112,222,POINT (-84.57630943002167 9.67253998098596),-84.57630943002167,9.67253998098596
940,44,67,112,223,POINT (-84.57630943002167 9.716403980985959),-84.57630943002167,9.716403980985959
941,43,69,113,225,POINT (-84.57630943002167 9.760267980985958),-84.57630943002167,9.760267980985958
942,37,66,114,217,POINT (-84.57630943002167 9.804131980985957),-84.57630943002167,9.804131980985957
943,36,67,112,215,POINT (-84.57630943002167 9.847995980985957),-84.57630943002167,9.847995980985957
944,32,65,112,209,POINT (-84.57630943002167 9.891859980985956),-84.57630943002167,9.891859980985956
945,32,65,117,214,POINT (-84.57630943002167 9.935723980985955),-84.57630943002167,9.935723980985955
946,30,64,120,214,POINT (-84.57630943002167 9.979587980985954),-84.57630943002167,9.979587980985954
947,30,60,122,212,POINT (-84.57630943002167 10.023451980985953),-84.57630943002167,10.023451980985953
948,29,58,131,218,POINT (-84.57630943002167 10.067315980985953),-84.57630943002167,10.067315980985953
949,30,55,132,217,POINT (-84.57630943002167 10.111179980985952),-84.57630943002167,10.111179980985952
950,30,61,135,226,POINT (-84.57630943002167 10.155043980985951),-84.57630943002167,10.155043980985951
951,37,60,135,232,POINT (-84.57630943002167 10.19890798098595),-84.57630943002167,10.19890798098595
952,42,60,131,233,POINT (-84.57630943002167 10.24277198098595),-84.57630943002167,10.24277198098595
953,38,67,129,234,POINT (-84.57630943002167 10.286635980985949),-84.57630943002167,10.286635980985949
954,40,73,126,239,POINT (-84.57630943002167 10.330499980985948),-84.57630943002167,10.330499980985948
955,51,75,127,253,POINT (-84.57630943002167 10.374363980985947),-84.57630943002167,10.374363980985947
956,52,72,129,253,POINT (-84.57630943002167 10.418227980985947),-84.57630943002167,10.418227980985947
957,50,69,130,249,POINT (-84.57630943002167 10.462091980985946),-84.57630943002167,10.462091980985946
958,49,66,135,250,POINT (-84.57630943002167 10.505955980985945),-84.57630943002167,10.505955980985945
959,50,63,137,250,POINT (-84.57630943002167 10.549819980985944),-84.57630943002167,10.549819980985944
960,48,59,137,244,POINT (-84.57630943002167 10.593683980985944),-84.57630943002167,10.593683980985944
961,44,58,138,240,POINT (-84.57630943002167 10.637547980985943),-84.57630943002167,10.637547980985943
962,43,59,139,241,POINT (-84.57630943002167 10.681411980985942),-84.57630943002167,10.681411980985942
963,43,61,137,241,POINT (-84.57630943002167 10.725275980985941),-84.57630943002167,10.725275980985941
964,42,59,136,237,POINT (-84.57630943002167 10.76913998098594),-84.57630943002167,10.76913998098594
965,42,58,135,235,POINT (-84.57630943002167 10.81300398098594),-84.57630943002167,10.81300398098594
966,41,62,134,237,POINT (-84.57630943002167 10.856867980985939),-84.57630943002167,10.856867980985939
967,39,63,132,234,POINT (-84.57630943002167 10.900731980985938),-84.57630943002167,10.900731980985938
968,38,63,131,232,POINT (-84.57630943002167 10.944595980985937),-84.57630943002167,10.944595980985937
969,38,63,132,233,POINT (-84.57630943002167 10.988459980985937),-84.57630943002167,10.988459980985937
970,35,61,128,224,POINT (-84.57630943002167 11.032323980985936),-84.57630943002167,11.032323980985936
971,41,66,111,218,POINT (-84.54037743002166 9.584811980985961),-84.54037743002166,9.584811980985961
972,44,67,110,221,POINT (-84.54037743002166 9.62867598098596),-84.54037743002166,9.62867598098596
973,44,67,115,226,POINT (-84.54037743002166 9.67253998098596),-84.54037743002166,9.67253998098596
974,43,69,116,228,POINT (-84.54037743002166 9.716403980985959),-84.54037743002166,9.716403980985959
975,42,67,118,227,POINT (-84.54037743002166 9.760267980985958),-84.54037743002166,9.760267980985958
976,41,68,117,226,POINT (-84.54037743002166 9.804131980985957),-84.54037743002166,9.804131980985957
977,36,64,118,218,POINT (-84.54037743002166 9.847995980985957),-84.54037743002166,9.847995980985957
978,32,62,118,212,POINT (-84.54037743002166 9.891859980985956),-84.54037743002166,9.891859980985956
979,31,63,120,214,POINT (-84.54037743002166 9.935723980985955),-84.54037743002166,9.935723980985955
980,29,60,122,211,POINT (-84.54037743002166 9.979587980985954),-84.54037743002166,9.979587980985954
981,28,58,130,216,POINT (-84.54037743002166 10.023451980985953),-84.54037743002166,10.023451980985953
982,29,59,129,217,POINT (-84.54037743002166 10.067315980985953),-84.54037743002166,10.067315980985953
983,29,59,135,223,POINT (-84.54037743002166 10.111179980985952),-84.54037743002166,10.111179980985952
984,29,62,135,226,POINT (-84.54037743002166 10.155043980985951),-84.54037743002166,10.155043980985951
985,34,63,133,230,POINT (-84.54037743002166 10.19890798098595),-84.54037743002166,10.19890798098595
986,38,64,131,233,POINT (-84.54037743002166 10.24277198098595),-84.54037743002166,10.24277198098595
987,35,70,130,235,POINT (-84.54037743002166 10.286635980985949),-84.54037743002166,10.286635980985949
988,41,76,128,245,POINT (-84.54037743002166 10.330499980985948),-84.54037743002166,10.330499980985948
989,52,72,129,253,POINT (-84.54037743002166 10.374363980985947),-84.54037743002166,10.374363980985947
990,51,68,130,249,POINT (-84.54037743002166 10.418227980985947),-84.54037743002166,10.418227980985947
991,49,67,133,249,POINT (-84.54037743002166 10.462091980985946),-84.54037743002166,10.462091980985946
992,47,64,137,248,POINT (-84.54037743002166 10.505955980985945),-84.54037743002166,10.505955980985945
993,49,61,136,246,POINT (-84.54037743002166 10.549819980985944),-84.54037743002166,10.549819980985944
994,48,58,138,244,POINT (-84.54037743002166 10.593683980985944),-84.54037743002166,10.593683980985944
995,44,59,137,240,POINT (-84.54037743002166 10.637547980985943),-84.54037743002166,10.637547980985943
996,43,61,136,240,POINT (-84.54037743002166 10.681411980985942),-84.54037743002166,10.681411980985942
997,43,61,137,241,POINT (-84.54037743002166 10.725275980985941),-84.54037743002166,10.725275980985941
998,41,63,136,240,POINT (-84.54037743002166 10.76913998098594),-84.54037743002166,10.76913998098594
999,42,66,133,241,POINT (-84.54037743002166 10.81300398098594),-84.54037743002166,10.81300398098594
1000,41,63,132,236,POINT (-84.54037743002166 10.856867980985939),-84.54037743002166,10.856867980985939
1001,40,64,133,237,POINT (-84.54037743002166 10.900731980985938),-84.54037743002166,10.900731980985938
1002,37,64,132,233,POINT (-84.54037743002166 10.944595980985937),-84.54037743002166,10.944595980985937
1003,37,64,131,232,POINT (-84.54037743002166 10.988459980985937),-84.54037743002166,10.988459980985937
1004,31,62,128,221,POINT (-84.54037743002166 11.032323980985936),-84.54037743002166,11.032323980985936
1005,43,67,112,222,POINT (-84.50444543002166 9.584811980985961),-84.50444543002166,9.584811980985961
1006,44,69,115,228,POINT (-84.50444543002166 9.62867598098596),-84.50444543002166,9.62867598098596
1007,44,67,116,227,POINT (-84.50444543002166 9.67253998098596),-84.50444543002166,9.67253998098596
1008,43,69,117,229,POINT (-84.50444543002166 9.716403980985959),-84.50444543002166,9.716403980985959
1009,42,68,119,229,POINT (-84.50444543002166 9.760267980985958),-84.50444543002166,9.760267980985958
1010,39,67,121,227,POINT (-84.50444543002166 9.804131980985957),-84.50444543002166,9.804131980985957
1011,36,57,123,216,POINT (-84.50444543002166 9.847995980985957),-84.50444543002166,9.847995980985957
1012,33,56,121,210,POINT (-84.50444543002166 9.891859980985956),-84.50444543002166,9.891859980985956
1013,29,59,123,211,POINT (-84.50444543002166 9.935723980985955),-84.50444543002166,9.935723980985955
1014,28,64,126,218,POINT (-84.50444543002166 9.979587980985954),-84.50444543002166,9.979587980985954
1015,27,58,130,215,POINT (-84.50444543002166 10.023451980985953),-84.50444543002166,10.023451980985953
1016,28,58,131,217,POINT (-84.50444543002166 10.067315980985953),-84.50444543002166,10.067315980985953
1017,26,61,134,221,POINT (-84.50444543002166 10.111179980985952),-84.50444543002166,10.111179980985952
1018,26,67,136,229,POINT (-84.50444543002166 10.155043980985951),-84.50444543002166,10.155043980985951
1019,32,63,135,230,POINT (-84.50444543002166 10.19890798098595),-84.50444543002166,10.19890798098595
1020,35,65,134,234,POINT (-84.50444543002166 10.24277198098595),-84.50444543002166,10.24277198098595
1021,37,76,128,241,POINT (-84.50444543002166 10.286635980985949),-84.50444543002166,10.286635980985949
1022,44,75,126,245,POINT (-84.50444543002166 10.330499980985948),-84.50444543002166,10.330499980985948
1023,51,74,129,254,POINT (-84.50444543002166 10.374363980985947),-84.50444543002166,10.374363980985947
1024,50,66,133,249,POINT (-84.50444543002166 10.418227980985947),-84.50444543002166,10.418227980985947
1025,47,66,137,250,POINT (-84.50444543002166 10.462091980985946),-84.50444543002166,10.462091980985946
1026,48,64,137,249,POINT (-84.50444543002166 10.505955980985945),-84.50444543002166,10.505955980985945
1027,49,61,138,248,POINT (-84.50444543002166 10.549819980985944),-84.50444543002166,10.549819980985944
1028,48,57,139,244,POINT (-84.50444543002166 10.593683980985944),-84.50444543002166,10.593683980985944
1029,45,59,138,242,POINT (-84.50444543002166 10.637547980985943),-84.50444543002166,10.637547980985943
1030,43,61,139,243,POINT (-84.50444543002166 10.681411980985942),-84.50444543002166,10.681411980985942
1031,42,63,139,244,POINT (-84.50444543002166 10.725275980985941),-84.50444543002166,10.725275980985941
1032,41,65,135,241,POINT (-84.50444543002166 10.76913998098594),-84.50444543002166,10.76913998098594
1033,41,65,134,240,POINT (-84.50444543002166 10.81300398098594),-84.50444543002166,10.81300398098594
1034,41,67,133,241,POINT (-84.50444543002166 10.856867980985939),-84.50444543002166,10.856867980985939
1035,39,66,131,236,POINT (-84.50444543002166 10.900731980985938),-84.50444543002166,10.900731980985938
1036,37,66,130,233,POINT (-84.50444543002166 10.944595980985937),-84.50444543002166,10.944595980985937
1037,36,65,128,229,POINT (-84.50444543002166 10.988459980985937),-84.50444543002166,10.988459980985937
1038,31,66,129,226,POINT (-84.50444543002166 11.032323980985936),-84.50444543002166,11.032323980985936
1039,43,68,115,226,POINT (-84.46851343002166 9.584811980985961),-84.46851343002166,9.584811980985961
1040,43,69,118,230,POINT (-84.46851343002166 9.62867598098596),-84.46851343002166,9.62867598098596
1041,43,69,119,231,POINT (-84.46851343002166 9.67253998098596),-84.46851343002166,9.67253998098596
1042,43,71,119,233,POINT (-84.46851343002166 9.716403980985959),-84.46851343002166,9.716403980985959
1043,42,68,126,236,POINT (-84.46851343002166 9.760267980985958),-84.46851343002166,9.760267980985958
1044,35,61,125,221,POINT (-84.46851343002166 9.804131980985957),-84.46851343002166,9.804131980985957
1045,34,59,124,217,POINT (-84.46851343002166 9.847995980985957),-84.46851343002166,9.847995980985957
1046,31,56,123,210,POINT (-84.46851343002166 9.891859980985956),-84.46851343002166,9.891859980985956
1047,28,59,124,211,POINT (-84.46851343002166 9.935723980985955),-84.46851343002166,9.935723980985955
1048,26,59,127,212,POINT (-84.46851343002166 9.979587980985954),-84.46851343002166,9.979587980985954
1049,28,56,127,211,POINT (-84.46851343002166 10.023451980985953),-84.46851343002166,10.023451980985953
1050,25,59,131,215,POINT (-84.46851343002166 10.067315980985953),-84.46851343002166,10.067315980985953
1051,24,62,134,220,POINT (-84.46851343002166 10.111179980985952),-84.46851343002166,10.111179980985952
1052,24,60,134,218,POINT (-84.46851343002166 10.155043980985951),-84.46851343002166,10.155043980985951
1053,28,64,132,224,POINT (-84.46851343002166 10.19890798098595),-84.46851343002166,10.19890798098595
1054,32,62,127,221,POINT (-84.46851343002166 10.24277198098595),-84.46851343002166,10.24277198098595
1055,35,69,125,229,POINT (-84.46851343002166 10.286635980985949),-84.46851343002166,10.286635980985949
1056,40,75,126,241,POINT (-84.46851343002166 10.330499980985948),-84.46851343002166,10.330499980985948
1057,50,70,125,245,POINT (-84.46851343002166 10.374363980985947),-84.46851343002166,10.374363980985947
1058,48,68,135,251,POINT (-84.46851343002166 10.418227980985947),-84.46851343002166,10.418227980985947
1059,47,66,138,251,POINT (-84.46851343002166 10.462091980985946),-84.46851343002166,10.462091980985946
1060,49,66,138,253,POINT (-84.46851343002166 10.505955980985945),-84.46851343002166,10.505955980985945
1061,48,61,138,247,POINT (-84.46851343002166 10.549819980985944),-84.46851343002166,10.549819980985944
1062,47,59,139,245,POINT (-84.46851343002166 10.593683980985944),-84.46851343002166,10.593683980985944
1063,45,59,142,246,POINT (-84.46851343002166 10.637547980985943),-84.46851343002166,10.637547980985943
1064,43,62,140,245,POINT (-84.46851343002166 10.681411980985942),-84.46851343002166,10.681411980985942
1065,42,62,137,241,POINT (-84.46851343002166 10.725275980985941),-84.46851343002166,10.725275980985941
1066,41,65,136,242,POINT (-84.46851343002166 10.76913998098594),-84.46851343002166,10.76913998098594
1067,41,67,135,243,POINT (-84.46851343002166 10.81300398098594),-84.46851343002166,10.81300398098594
1068,40,67,133,240,POINT (-84.46851343002166 10.856867980985939),-84.46851343002166,10.856867980985939
1069,39,68,132,239,POINT (-84.46851343002166 10.900731980985938),-84.46851343002166,10.900731980985938
1070,38,69,132,239,POINT (-84.46851343002166 10.944595980985937),-84.46851343002166,10.944595980985937
1071,32,72,129,233,POINT (-84.46851343002166 10.988459980985937),-84.46851343002166,10.988459980985937
1072,42,69,116,227,POINT (-84.43258143002166 9.540947980985962),-84.43258143002166,9.540947980985962
1073,43,70,118,231,POINT (-84.43258143002166 9.584811980985961),-84.43258143002166,9.584811980985961
1074,42,70,120,232,POINT (-84.43258143002166 9.62867598098596),-84.43258143002166,9.62867598098596
1075,43,70,120,233,POINT (-84.43258143002166 9.67253998098596),-84.43258143002166,9.67253998098596
1076,42,70,122,234,POINT (-84.43258143002166 9.716403980985959),-84.43258143002166,9.716403980985959
1077,37,65,126,228,POINT (-84.43258143002166 9.760267980985958),-84.43258143002166,9.760267980985958
1078,34,60,125,219,POINT (-84.43258143002166 9.804131980985957),-84.43258143002166,9.804131980985957
1079,33,60,124,217,POINT (-84.43258143002166 9.847995980985957),-84.43258143002166,9.847995980985957
1080,29,60,125,214,POINT (-84.43258143002166 9.891859980985956),-84.43258143002166,9.891859980985956
1081,27,58,124,209,POINT (-84.43258143002166 9.935723980985955),-84.43258143002166,9.935723980985955
1082,27,56,125,208,POINT (-84.43258143002166 9.979587980985954),-84.43258143002166,9.979587980985954
1083,26,57,127,210,POINT (-84.43258143002166 10.023451980985953),-84.43258143002166,10.023451980985953
1084,23,62,129,214,POINT (-84.43258143002166 10.067315980985953),-84.43258143002166,10.067315980985953
1085,24,66,130,220,POINT (-84.43258143002166 10.111179980985952),-84.43258143002166,10.111179980985952
1086,23,62,134,219,POINT (-84.43258143002166 10.155043980985951),-84.43258143002166,10.155043980985951
1087,28,58,129,215,POINT (-84.43258143002166 10.19890798098595),-84.43258143002166,10.19890798098595
1088,29,59,126,214,POINT (-84.43258143002166 10.24277198098595),-84.43258143002166,10.24277198098595
1089,34,69,127,230,POINT (-84.43258143002166 10.286635980985949),-84.43258143002166,10.286635980985949
1090,39,70,127,236,POINT (-84.43258143002166 10.330499980985948),-84.43258143002166,10.330499980985948
1091,49,68,132,249,POINT (-84.43258143002166 10.374363980985947),-84.43258143002166,10.374363980985947
1092,49,66,135,250,POINT (-84.43258143002166 10.418227980985947),-84.43258143002166,10.418227980985947
1093,50,68,139,257,POINT (-84.43258143002166 10.462091980985946),-84.43258143002166,10.462091980985946
1094,49,66,141,256,POINT (-84.43258143002166 10.505955980985945),-84.43258143002166,10.505955980985945
1095,48,61,142,251,POINT (-84.43258143002166 10.549819980985944),-84.43258143002166,10.549819980985944
1096,47,61,141,249,POINT (-84.43258143002166 10.593683980985944),-84.43258143002166,10.593683980985944
1097,45,60,140,245,POINT (-84.43258143002166 10.637547980985943),-84.43258143002166,10.637547980985943
1098,43,61,139,243,POINT (-84.43258143002166 10.681411980985942),-84.43258143002166,10.681411980985942
1099,42,66,136,244,POINT (-84.43258143002166 10.725275980985941),-84.43258143002166,10.725275980985941
1100,40,66,135,241,POINT (-84.43258143002166 10.76913998098594),-84.43258143002166,10.76913998098594
1101,40,68,136,244,POINT (-84.43258143002166 10.81300398098594),-84.43258143002166,10.81300398098594
1102,40,69,135,244,POINT (-84.43258143002166 10.856867980985939),-84.43258143002166,10.856867980985939
1103,39,70,132,241,POINT (-84.43258143002166 10.900731980985938),-84.43258143002166,10.900731980985938
1104,38,71,134,243,POINT (-84.43258143002166 10.944595980985937),-84.43258143002166,10.944595980985937
1105,33,72,131,236,POINT (-84.43258143002166 10.988459980985937),-84.43258143002166,10.988459980985937
1106,42,69,118,229,POINT (-84.39664943002165 9.540947980985962),-84.39664943002165,9.540947980985962
1107,42,72,121,235,POINT (-84.39664943002165 9.584811980985961),-84.39664943002165,9.584811980985961
1108,41,71,121,233,POINT (-84.39664943002165 9.62867598098596),-84.39664943002165,9.62867598098596
1109,41,73,122,236,POINT (-84.39664943002165 9.67253998098596),-84.39664943002165,9.67253998098596
1110,44,73,124,241,POINT (-84.39664943002165 9.716403980985959),-84.39664943002165,9.716403980985959
1111,38,65,125,228,POINT (-84.39664943002165 9.760267980985958),-84.39664943002165,9.760267980985958
1112,34,59,126,219,POINT (-84.39664943002165 9.804131980985957),-84.39664943002165,9.804131980985957
1113,33,61,128,222,POINT (-84.39664943002165 9.847995980985957),-84.39664943002165,9.847995980985957
1114,28,60,127,215,POINT (-84.39664943002165 9.891859980985956),-84.39664943002165,9.891859980985956
1115,27,58,126,211,POINT (-84.39664943002165 9.935723980985955),-84.39664943002165,9.935723980985955
1116,27,56,126,209,POINT (-84.39664943002165 9.979587980985954),-84.39664943002165,9.979587980985954
1117,27,59,126,212,POINT (-84.39664943002165 10.023451980985953),-84.39664943002165,10.023451980985953
1118,24,62,133,219,POINT (-84.39664943002165 10.067315980985953),-84.39664943002165,10.067315980985953
1119,22,66,133,221,POINT (-84.39664943002165 10.111179980985952),-84.39664943002165,10.111179980985952
1120,21,63,132,216,POINT (-84.39664943002165 10.155043980985951),-84.39664943002165,10.155043980985951
1121,23,57,129,209,POINT (-84.39664943002165 10.19890798098595),-84.39664943002165,10.19890798098595
1122,23,54,127,204,POINT (-84.39664943002165 10.24277198098595),-84.39664943002165,10.24277198098595
1123,25,62,129,216,POINT (-84.39664943002165 10.286635980985949),-84.39664943002165,10.286635980985949
1124,39,70,131,240,POINT (-84.39664943002165 10.330499980985948),-84.39664943002165,10.330499980985948
1125,50,66,136,252,POINT (-84.39664943002165 10.374363980985947),-84.39664943002165,10.374363980985947
1126,50,67,140,257,POINT (-84.39664943002165 10.418227980985947),-84.39664943002165,10.418227980985947
1127,51,67,140,258,POINT (-84.39664943002165 10.462091980985946),-84.39664943002165,10.462091980985946
1128,49,63,140,252,POINT (-84.39664943002165 10.505955980985945),-84.39664943002165,10.505955980985945
1129,48,58,139,245,POINT (-84.39664943002165 10.549819980985944),-84.39664943002165,10.549819980985944
1130,46,59,140,245,POINT (-84.39664943002165 10.593683980985944),-84.39664943002165,10.593683980985944
1131,45,62,140,247,POINT (-84.39664943002165 10.637547980985943),-84.39664943002165,10.637547980985943
1132,43,65,139,247,POINT (-84.39664943002165 10.681411980985942),-84.39664943002165,10.681411980985942
1133,40,66,137,243,POINT (-84.39664943002165 10.725275980985941),-84.39664943002165,10.725275980985941
1134,40,69,135,244,POINT (-84.39664943002165 10.76913998098594),-84.39664943002165,10.76913998098594
1135,40,73,136,249,POINT (-84.39664943002165 10.81300398098594),-84.39664943002165,10.81300398098594
1136,40,72,136,248,POINT (-84.39664943002165 10.856867980985939),-84.39664943002165,10.856867980985939
1137,38,71,135,244,POINT (-84.39664943002165 10.900731980985938),-84.39664943002165,10.900731980985938
1138,37,69,131,237,POINT (-84.39664943002165 10.944595980985937),-84.39664943002165,10.944595980985937
1139,32,74,129,235,POINT (-84.39664943002165 10.988459980985937),-84.39664943002165,10.988459980985937
1140,43,70,119,232,POINT (-84.36071743002165 9.540947980985962),-84.36071743002165,9.540947980985962
1141,43,72,121,236,POINT (-84.36071743002165 9.584811980985961),-84.36071743002165,9.584811980985961
1142,42,74,122,238,POINT (-84.36071743002165 9.62867598098596),-84.36071743002165,9.62867598098596
1143,40,71,123,234,POINT (-84.36071743002165 9.67253998098596),-84.36071743002165,9.67253998098596
1144,44,69,124,237,POINT (-84.36071743002165 9.716403980985959),-84.36071743002165,9.716403980985959
1145,38,64,124,226,POINT (-84.36071743002165 9.760267980985958),-84.36071743002165,9.760267980985958
1146,32,59,129,220,POINT (-84.36071743002165 9.804131980985957),-84.36071743002165,9.804131980985957
1147,28,61,129,218,POINT (-84.36071743002165 9.847995980985957),-84.36071743002165,9.847995980985957
1148,27,59,129,215,POINT (-84.36071743002165 9.891859980985956),-84.36071743002165,9.891859980985956
1149,26,57,124,207,POINT (-84.36071743002165 9.935723980985955),-84.36071743002165,9.935723980985955
1150,25,58,123,206,POINT (-84.36071743002165 9.979587980985954),-84.36071743002165,9.979587980985954
1151,24,62,132,218,POINT (-84.36071743002165 10.023451980985953),-84.36071743002165,10.023451980985953
1152,22,61,131,214,POINT (-84.36071743002165 10.067315980985953),-84.36071743002165,10.067315980985953
1153,19,64,129,212,POINT (-84.36071743002165 10.111179980985952),-84.36071743002165,10.111179980985952
1154,19,56,128,203,POINT (-84.36071743002165 10.155043980985951),-84.36071743002165,10.155043980985951
1155,23,55,128,206,POINT (-84.36071743002165 10.19890798098595),-84.36071743002165,10.19890798098595
1156,21,52,126,199,POINT (-84.36071743002165 10.24277198098595),-84.36071743002165,10.24277198098595
1157,21,57,130,208,POINT (-84.36071743002165 10.286635980985949),-84.36071743002165,10.286635980985949
1158,38,66,135,239,POINT (-84.36071743002165 10.330499980985948),-84.36071743002165,10.330499980985948
1159,49,65,138,252,POINT (-84.36071743002165 10.374363980985947),-84.36071743002165,10.374363980985947
1160,50,68,142,260,POINT (-84.36071743002165 10.418227980985947),-84.36071743002165,10.418227980985947
1161,51,66,139,256,POINT (-84.36071743002165 10.462091980985946),-84.36071743002165,10.462091980985946
1162,49,64,140,253,POINT (-84.36071743002165 10.505955980985945),-84.36071743002165,10.505955980985945
1163,48,61,140,249,POINT (-84.36071743002165 10.549819980985944),-84.36071743002165,10.549819980985944
1164,46,61,140,247,POINT (-84.36071743002165 10.593683980985944),-84.36071743002165,10.593683980985944
1165,44,64,140,248,POINT (-84.36071743002165 10.637547980985943),-84.36071743002165,10.637547980985943
1166,42,68,140,250,POINT (-84.36071743002165 10.681411980985942),-84.36071743002165,10.681411980985942
1167,40,72,138,250,POINT (-84.36071743002165 10.725275980985941),-84.36071743002165,10.725275980985941
1168,42,73,138,253,POINT (-84.36071743002165 10.76913998098594),-84.36071743002165,10.76913998098594
1169,41,73,137,251,POINT (-84.36071743002165 10.81300398098594),-84.36071743002165,10.81300398098594
1170,41,74,135,250,POINT (-84.36071743002165 10.856867980985939),-84.36071743002165,10.856867980985939
1171,37,72,132,241,POINT (-84.36071743002165 10.900731980985938),-84.36071743002165,10.900731980985938
1172,37,73,130,240,POINT (-84.36071743002165 10.944595980985937),-84.36071743002165,10.944595980985937
1173,34,74,129,237,POINT (-84.36071743002165 10.988459980985937),-84.36071743002165,10.988459980985937
1174,44,68,116,228,POINT (-84.32478543002165 9.497083980985963),-84.32478543002165,9.497083980985963
1175,44,70,120,234,POINT (-84.32478543002165 9.540947980985962),-84.32478543002165,9.540947980985962
1176,42,72,122,236,POINT (-84.32478543002165 9.584811980985961),-84.32478543002165,9.584811980985961
1177,42,72,123,237,POINT (-84.32478543002165 9.62867598098596),-84.32478543002165,9.62867598098596
1178,41,72,124,237,POINT (-84.32478543002165 9.67253998098596),-84.32478543002165,9.67253998098596
1179,40,62,124,226,POINT (-84.32478543002165 9.716403980985959),-84.32478543002165,9.716403980985959
1180,35,60,127,222,POINT (-84.32478543002165 9.760267980985958),-84.32478543002165,9.760267980985958
1181,30,56,130,216,POINT (-84.32478543002165 9.804131980985957),-84.32478543002165,9.804131980985957
1182,27,56,130,213,POINT (-84.32478543002165 9.847995980985957),-84.32478543002165,9.847995980985957
1183,25,57,128,210,POINT (-84.32478543002165 9.891859980985956),-84.32478543002165,9.891859980985956
1184,24,58,124,206,POINT (-84.32478543002165 9.935723980985955),-84.32478543002165,9.935723980985955
1185,24,59,126,209,POINT (-84.32478543002165 9.979587980985954),-84.32478543002165,9.979587980985954
1186,22,60,132,214,POINT (-84.32478543002165 10.023451980985953),-84.32478543002165,10.023451980985953
1187,19,60,127,206,POINT (-84.32478543002165 10.067315980985953),-84.32478543002165,10.067315980985953
1188,17,57,129,203,POINT (-84.32478543002165 10.111179980985952),-84.32478543002165,10.111179980985952
1189,20,58,126,204,POINT (-84.32478543002165 10.155043980985951),-84.32478543002165,10.155043980985951
1190,21,57,127,205,POINT (-84.32478543002165 10.19890798098595),-84.32478543002165,10.19890798098595
1191,24,57,127,208,POINT (-84.32478543002165 10.24277198098595),-84.32478543002165,10.24277198098595
1192,24,59,129,212,POINT (-84.32478543002165 10.286635980985949),-84.32478543002165,10.286635980985949
1193,42,62,140,244,POINT (-84.32478543002165 10.330499980985948),-84.32478543002165,10.330499980985948
1194,47,68,141,256,POINT (-84.32478543002165 10.374363980985947),-84.32478543002165,10.374363980985947
1195,50,70,143,263,POINT (-84.32478543002165 10.418227980985947),-84.32478543002165,10.418227980985947
1196,52,66,142,260,POINT (-84.32478543002165 10.462091980985946),-84.32478543002165,10.462091980985946
1197,48,65,142,255,POINT (-84.32478543002165 10.505955980985945),-84.32478543002165,10.505955980985945
1198,48,63,141,252,POINT (-84.32478543002165 10.549819980985944),-84.32478543002165,10.549819980985944
1199,45,66,142,253,POINT (-84.32478543002165 10.593683980985944),-84.32478543002165,10.593683980985944
1200,44,67,142,253,POINT (-84.32478543002165 10.637547980985943),-84.32478543002165,10.637547980985943
1201,44,71,139,254,POINT (-84.32478543002165 10.681411980985942),-84.32478543002165,10.681411980985942
1202,41,73,139,253,POINT (-84.32478543002165 10.725275980985941),-84.32478543002165,10.725275980985941
1203,41,75,138,254,POINT (-84.32478543002165 10.76913998098594),-84.32478543002165,10.76913998098594
1204,40,74,136,250,POINT (-84.32478543002165 10.81300398098594),-84.32478543002165,10.81300398098594
1205,40,75,132,247,POINT (-84.32478543002165 10.856867980985939),-84.32478543002165,10.856867980985939
1206,40,73,130,243,POINT (-84.32478543002165 10.900731980985938),-84.32478543002165,10.900731980985938
1207,41,75,130,246,POINT (-84.32478543002165 10.944595980985937),-84.32478543002165,10.944595980985937
1208,43,69,120,232,POINT (-84.28885343002165 9.497083980985963),-84.28885343002165,9.497083980985963
1209,44,70,123,237,POINT (-84.28885343002165 9.540947980985962),-84.28885343002165,9.540947980985962
1210,43,72,124,239,POINT (-84.28885343002165 9.584811980985961),-84.28885343002165,9.584811980985961
1211,42,70,126,238,POINT (-84.28885343002165 9.62867598098596),-84.28885343002165,9.62867598098596
1212,41,71,124,236,POINT (-84.28885343002165 9.67253998098596),-84.28885343002165,9.67253998098596
1213,38,62,131,231,POINT (-84.28885343002165 9.716403980985959),-84.28885343002165,9.716403980985959
1214,32,54,128,214,POINT (-84.28885343002165 9.760267980985958),-84.28885343002165,9.760267980985958
1215,28,56,132,216,POINT (-84.28885343002165 9.804131980985957),-84.28885343002165,9.804131980985957
1216,26,54,133,213,POINT (-84.28885343002165 9.847995980985957),-84.28885343002165,9.847995980985957
1217,23,55,129,207,POINT (-84.28885343002165 9.891859980985956),-84.28885343002165,9.891859980985956
1218,22,54,124,200,POINT (-84.28885343002165 9.935723980985955),-84.28885343002165,9.935723980985955
1219,20,55,131,206,POINT (-84.28885343002165 9.979587980985954),-84.28885343002165,9.979587980985954
1220,20,59,130,209,POINT (-84.28885343002165 10.023451980985953),-84.28885343002165,10.023451980985953
1221,18,58,126,202,POINT (-84.28885343002165 10.067315980985953),-84.28885343002165,10.067315980985953
1222,17,61,124,202,POINT (-84.28885343002165 10.111179980985952),-84.28885343002165,10.111179980985952
1223,22,57,130,209,POINT (-84.28885343002165 10.155043980985951),-84.28885343002165,10.155043980985951
1224,22,58,130,210,POINT (-84.28885343002165 10.19890798098595),-84.28885343002165,10.19890798098595
1225,27,54,132,213,POINT (-84.28885343002165 10.24277198098595),-84.28885343002165,10.24277198098595
1226,30,58,130,218,POINT (-84.28885343002165 10.286635980985949),-84.28885343002165,10.286635980985949
1227,40,66,139,245,POINT (-84.28885343002165 10.330499980985948),-84.28885343002165,10.330499980985948
1228,45,70,142,257,POINT (-84.28885343002165 10.374363980985947),-84.28885343002165,10.374363980985947
1229,51,72,143,266,POINT (-84.28885343002165 10.418227980985947),-84.28885343002165,10.418227980985947
1230,52,67,143,262,POINT (-84.28885343002165 10.462091980985946),-84.28885343002165,10.462091980985946
1231,49,66,142,257,POINT (-84.28885343002165 10.505955980985945),-84.28885343002165,10.505955980985945
1232,47,66,142,255,POINT (-84.28885343002165 10.549819980985944),-84.28885343002165,10.549819980985944
1233,45,68,142,255,POINT (-84.28885343002165 10.593683980985944),-84.28885343002165,10.593683980985944
1234,44,69,140,253,POINT (-84.28885343002165 10.637547980985943),-84.28885343002165,10.637547980985943
1235,44,71,141,256,POINT (-84.28885343002165 10.681411980985942),-84.28885343002165,10.681411980985942
1236,41,73,140,254,POINT (-84.28885343002165 10.725275980985941),-84.28885343002165,10.725275980985941
1237,42,74,136,252,POINT (-84.28885343002165 10.76913998098594),-84.28885343002165,10.76913998098594
1238,41,75,134,250,POINT (-84.28885343002165 10.81300398098594),-84.28885343002165,10.81300398098594
1239,42,75,131,248,POINT (-84.28885343002165 10.856867980985939),-84.28885343002165,10.856867980985939
1240,39,77,128,244,POINT (-84.28885343002165 10.900731980985938),-84.28885343002165,10.900731980985938
1241,0,12,35,47,POINT (-84.25292143002164 9.497083980985963),-84.25292143002164,9.497083980985963
1242,43,70,123,236,POINT (-84.25292143002164 9.540947980985962),-84.25292143002164,9.540947980985962
1243,42,72,124,238,POINT (-84.25292143002164 9.584811980985961),-84.25292143002164,9.584811980985961
1244,40,70,126,236,POINT (-84.25292143002164 9.62867598098596),-84.25292143002164,9.62867598098596
1245,39,62,127,228,POINT (-84.25292143002164 9.67253998098596),-84.25292143002164,9.67253998098596
1246,35,61,129,225,POINT (-84.25292143002164 9.716403980985959),-84.25292143002164,9.716403980985959
1247,29,52,129,210,POINT (-84.25292143002164 9.760267980985958),-84.25292143002164,9.760267980985958
1248,25,52,133,210,POINT (-84.25292143002164 9.804131980985957),-84.25292143002164,9.804131980985957
1249,23,55,132,210,POINT (-84.25292143002164 9.847995980985957),-84.25292143002164,9.847995980985957
1250,21,53,133,207,POINT (-84.25292143002164 9.891859980985956),-84.25292143002164,9.891859980985956
1251,22,50,131,203,POINT (-84.25292143002164 9.935723980985955),-84.25292143002164,9.935723980985955
1252,20,53,130,203,POINT (-84.25292143002164 9.979587980985954),-84.25292143002164,9.979587980985954
1253,19,57,123,199,POINT (-84.25292143002164 10.023451980985953),-84.25292143002164,10.023451980985953
1254,17,56,124,197,POINT (-84.25292143002164 10.067315980985953),-84.25292143002164,10.067315980985953
1255,17,57,129,203,POINT (-84.25292143002164 10.111179980985952),-84.25292143002164,10.111179980985952
1256,22,57,130,209,POINT (-84.25292143002164 10.155043980985951),-84.25292143002164,10.155043980985951
1257,25,48,132,205,POINT (-84.25292143002164 10.19890798098595),-84.25292143002164,10.19890798098595
1258,30,55,132,217,POINT (-84.25292143002164 10.24277198098595),-84.25292143002164,10.24277198098595
1259,32,61,133,226,POINT (-84.25292143002164 10.286635980985949),-84.25292143002164,10.286635980985949
1260,41,73,140,254,POINT (-84.25292143002164 10.330499980985948),-84.25292143002164,10.330499980985948
1261,47,74,144,265,POINT (-84.25292143002164 10.374363980985947),-84.25292143002164,10.374363980985947
1262,51,71,141,263,POINT (-84.25292143002164 10.418227980985947),-84.25292143002164,10.418227980985947
1263,52,70,144,266,POINT (-84.25292143002164 10.462091980985946),-84.25292143002164,10.462091980985946
1264,48,67,142,257,POINT (-84.25292143002164 10.505955980985945),-84.25292143002164,10.505955980985945
1265,47,69,141,257,POINT (-84.25292143002164 10.549819980985944),-84.25292143002164,10.549819980985944
1266,46,70,141,257,POINT (-84.25292143002164 10.593683980985944),-84.25292143002164,10.593683980985944
1267,45,69,140,254,POINT (-84.25292143002164 10.637547980985943),-84.25292143002164,10.637547980985943
1268,43,71,141,255,POINT (-84.25292143002164 10.681411980985942),-84.25292143002164,10.681411980985942
1269,42,75,139,256,POINT (-84.25292143002164 10.725275980985941),-84.25292143002164,10.725275980985941
1270,41,75,134,250,POINT (-84.25292143002164 10.76913998098594),-84.25292143002164,10.76913998098594
1271,40,75,131,246,POINT (-84.25292143002164 10.81300398098594),-84.25292143002164,10.81300398098594
1272,39,75,127,241,POINT (-84.25292143002164 10.856867980985939),-84.25292143002164,10.856867980985939
1273,42,14,111,167,POINT (-84.21698943002164 9.453219980985963),-84.21698943002164,9.453219980985963
1274,42,70,122,234,POINT (-84.21698943002164 9.497083980985963),-84.21698943002164,9.497083980985963
1275,42,70,123,235,POINT (-84.21698943002164 9.540947980985962),-84.21698943002164,9.540947980985962
1276,41,69,126,236,POINT (-84.21698943002164 9.584811980985961),-84.21698943002164,9.584811980985961
1277,39,67,126,232,POINT (-84.21698943002164 9.62867598098596),-84.21698943002164,9.62867598098596
1278,37,61,131,229,POINT (-84.21698943002164 9.67253998098596),-84.21698943002164,9.67253998098596
1279,32,59,133,224,POINT (-84.21698943002164 9.716403980985959),-84.21698943002164,9.716403980985959
1280,24,55,131,210,POINT (-84.21698943002164 9.760267980985958),-84.21698943002164,9.760267980985958
1281,22,52,135,209,POINT (-84.21698943002164 9.804131980985957),-84.21698943002164,9.804131980985957
1282,20,52,135,207,POINT (-84.21698943002164 9.847995980985957),-84.21698943002164,9.847995980985957
1283,20,51,137,208,POINT (-84.21698943002164 9.891859980985956),-84.21698943002164,9.891859980985956
1284,23,48,134,205,POINT (-84.21698943002164 9.935723980985955),-84.21698943002164,9.935723980985955
1285,22,50,126,198,POINT (-84.21698943002164 9.979587980985954),-84.21698943002164,9.979587980985954
1286,19,56,124,199,POINT (-84.21698943002164 10.023451980985953),-84.21698943002164,10.023451980985953
1287,18,56,121,195,POINT (-84.21698943002164 10.067315980985953),-84.21698943002164,10.067315980985953
1288,21,58,128,207,POINT (-84.21698943002164 10.111179980985952),-84.21698943002164,10.111179980985952
1289,23,50,129,202,POINT (-84.21698943002164 10.155043980985951),-84.21698943002164,10.155043980985951
1290,25,49,131,205,POINT (-84.21698943002164 10.19890798098595),-84.21698943002164,10.19890798098595
1291,29,55,133,217,POINT (-84.21698943002164 10.24277198098595),-84.21698943002164,10.24277198098595
1292,36,66,139,241,POINT (-84.21698943002164 10.286635980985949),-84.21698943002164,10.286635980985949
1293,44,73,142,259,POINT (-84.21698943002164 10.330499980985948),-84.21698943002164,10.330499980985948
1294,47,76,144,267,POINT (-84.21698943002164 10.374363980985947),-84.21698943002164,10.374363980985947
1295,51,73,144,268,POINT (-84.21698943002164 10.418227980985947),-84.21698943002164,10.418227980985947
1296,52,71,142,265,POINT (-84.21698943002164 10.462091980985946),-84.21698943002164,10.462091980985946
1297,49,69,143,261,POINT (-84.21698943002164 10.505955980985945),-84.21698943002164,10.505955980985945
1298,48,71,143,262,POINT (-84.21698943002164 10.549819980985944),-84.21698943002164,10.549819980985944
1299,45,70,140,255,POINT (-84.21698943002164 10.593683980985944),-84.21698943002164,10.593683980985944
1300,43,70,141,254,POINT (-84.21698943002164 10.637547980985943),-84.21698943002164,10.637547980985943
1301,42,71,140,253,POINT (-84.21698943002164 10.681411980985942),-84.21698943002164,10.681411980985942
1302,41,73,135,249,POINT (-84.21698943002164 10.725275980985941),-84.21698943002164,10.725275980985941
1303,40,74,132,246,POINT (-84.21698943002164 10.76913998098594),-84.21698943002164,10.76913998098594
1304,41,75,129,245,POINT (-84.21698943002164 10.81300398098594),-84.21698943002164,10.81300398098594
1305,41,68,122,231,POINT (-84.18105743002164 9.453219980985963),-84.18105743002164,9.453219980985963
1306,41,70,123,234,POINT (-84.18105743002164 9.497083980985963),-84.18105743002164,9.497083980985963
1307,43,71,124,238,POINT (-84.18105743002164 9.540947980985962),-84.18105743002164,9.540947980985962
1308,41,64,127,232,POINT (-84.18105743002164 9.584811980985961),-84.18105743002164,9.584811980985961
1309,39,66,131,236,POINT (-84.18105743002164 9.62867598098596),-84.18105743002164,9.62867598098596
1310,33,54,136,223,POINT (-84.18105743002164 9.67253998098596),-84.18105743002164,9.67253998098596
1311,23,45,135,203,POINT (-84.18105743002164 9.716403980985959),-84.18105743002164,9.716403980985959
1312,22,44,135,201,POINT (-84.18105743002164 9.760267980985958),-84.18105743002164,9.760267980985958
1313,20,45,136,201,POINT (-84.18105743002164 9.804131980985957),-84.18105743002164,9.804131980985957
1314,20,50,137,207,POINT (-84.18105743002164 9.847995980985957),-84.18105743002164,9.847995980985957
1315,19,47,138,204,POINT (-84.18105743002164 9.891859980985956),-84.18105743002164,9.891859980985956
1316,22,50,133,205,POINT (-84.18105743002164 9.935723980985955),-84.18105743002164,9.935723980985955
1317,20,47,126,193,POINT (-84.18105743002164 9.979587980985954),-84.18105743002164,9.979587980985954
1318,18,50,120,188,POINT (-84.18105743002164 10.023451980985953),-84.18105743002164,10.023451980985953
1319,20,56,124,200,POINT (-84.18105743002164 10.067315980985953),-84.18105743002164,10.067315980985953
1320,20,58,128,206,POINT (-84.18105743002164 10.111179980985952),-84.18105743002164,10.111179980985952
1321,25,54,130,209,POINT (-84.18105743002164 10.155043980985951),-84.18105743002164,10.155043980985951
1322,29,58,132,219,POINT (-84.18105743002164 10.19890798098595),-84.18105743002164,10.19890798098595
1323,36,63,132,231,POINT (-84.18105743002164 10.24277198098595),-84.18105743002164,10.24277198098595
1324,39,70,136,245,POINT (-84.18105743002164 10.286635980985949),-84.18105743002164,10.286635980985949
1325,44,76,141,261,POINT (-84.18105743002164 10.330499980985948),-84.18105743002164,10.330499980985948
1326,49,76,144,269,POINT (-84.18105743002164 10.374363980985947),-84.18105743002164,10.374363980985947
1327,51,73,145,269,POINT (-84.18105743002164 10.418227980985947),-84.18105743002164,10.418227980985947
1328,52,73,144,269,POINT (-84.18105743002164 10.462091980985946),-84.18105743002164,10.462091980985946
1329,50,71,144,265,POINT (-84.18105743002164 10.505955980985945),-84.18105743002164,10.505955980985945
1330,48,71,144,263,POINT (-84.18105743002164 10.549819980985944),-84.18105743002164,10.549819980985944
1331,45,71,141,257,POINT (-84.18105743002164 10.593683980985944),-84.18105743002164,10.593683980985944
1332,43,72,140,255,POINT (-84.18105743002164 10.637547980985943),-84.18105743002164,10.637547980985943
1333,43,71,138,252,POINT (-84.18105743002164 10.681411980985942),-84.18105743002164,10.681411980985942
1334,42,73,135,250,POINT (-84.18105743002164 10.725275980985941),-84.18105743002164,10.725275980985941
1335,40,74,132,246,POINT (-84.18105743002164 10.76913998098594),-84.18105743002164,10.76913998098594
1336,42,71,122,235,POINT (-84.14512543002164 9.409355980985964),-84.14512543002164,9.409355980985964
1337,42,73,124,239,POINT (-84.14512543002164 9.453219980985963),-84.14512543002164,9.453219980985963
1338,42,71,124,237,POINT (-84.14512543002164 9.497083980985963),-84.14512543002164,9.497083980985963
1339,42,68,125,235,POINT (-84.14512543002164 9.540947980985962),-84.14512543002164,9.540947980985962
1340,39,64,131,234,POINT (-84.14512543002164 9.584811980985961),-84.14512543002164,9.584811980985961
1341,34,54,134,222,POINT (-84.14512543002164 9.62867598098596),-84.14512543002164,9.62867598098596
1342,30,52,135,217,POINT (-84.14512543002164 9.67253998098596),-84.14512543002164,9.67253998098596
1343,22,43,138,203,POINT (-84.14512543002164 9.716403980985959),-84.14512543002164,9.716403980985959
1344,21,43,137,201,POINT (-84.14512543002164 9.760267980985958),-84.14512543002164,9.760267980985958
1345,18,46,137,201,POINT (-84.14512543002164 9.804131980985957),-84.14512543002164,9.804131980985957
1346,22,43,140,205,POINT (-84.14512543002164 9.847995980985957),-84.14512543002164,9.847995980985957
1347,21,44,137,202,POINT (-84.14512543002164 9.891859980985956),-84.14512543002164,9.891859980985956
1348,20,45,129,194,POINT (-84.14512543002164 9.935723980985955),-84.14512543002164,9.935723980985955
1349,19,48,120,187,POINT (-84.14512543002164 9.979587980985954),-84.14512543002164,9.979587980985954
1350,21,55,121,197,POINT (-84.14512543002164 10.023451980985953),-84.14512543002164,10.023451980985953
1351,22,58,127,207,POINT (-84.14512543002164 10.067315980985953),-84.14512543002164,10.067315980985953
1352,25,57,130,212,POINT (-84.14512543002164 10.111179980985952),-84.14512543002164,10.111179980985952
1353,26,55,131,212,POINT (-84.14512543002164 10.155043980985951),-84.14512543002164,10.155043980985951
1354,31,63,133,227,POINT (-84.14512543002164 10.19890798098595),-84.14512543002164,10.19890798098595
1355,35,62,137,234,POINT (-84.14512543002164 10.24277198098595),-84.14512543002164,10.24277198098595
1356,42,76,139,257,POINT (-84.14512543002164 10.286635980985949),-84.14512543002164,10.286635980985949
1357,47,77,144,268,POINT (-84.14512543002164 10.330499980985948),-84.14512543002164,10.330499980985948
1358,49,80,144,273,POINT (-84.14512543002164 10.374363980985947),-84.14512543002164,10.374363980985947
1359,52,77,144,273,POINT (-84.14512543002164 10.418227980985947),-84.14512543002164,10.418227980985947
1360,53,75,145,273,POINT (-84.14512543002164 10.462091980985946),-84.14512543002164,10.462091980985946
1361,50,73,144,267,POINT (-84.14512543002164 10.505955980985945),-84.14512543002164,10.505955980985945
1362,49,72,141,262,POINT (-84.14512543002164 10.549819980985944),-84.14512543002164,10.549819980985944
1363,44,73,140,257,POINT (-84.14512543002164 10.593683980985944),-84.14512543002164,10.593683980985944
1364,43,72,137,252,POINT (-84.14512543002164 10.637547980985943),-84.14512543002164,10.637547980985943
1365,43,73,136,252,POINT (-84.14512543002164 10.681411980985942),-84.14512543002164,10.681411980985942
1366,43,76,134,253,POINT (-84.14512543002164 10.725275980985941),-84.14512543002164,10.725275980985941
1367,41,76,130,247,POINT (-84.14512543002164 10.76913998098594),-84.14512543002164,10.76913998098594
1368,44,70,124,238,POINT (-84.10919343002163 9.409355980985964),-84.10919343002163,9.409355980985964
1369,43,71,125,239,POINT (-84.10919343002163 9.453219980985963),-84.10919343002163,9.453219980985963
1370,43,70,125,238,POINT (-84.10919343002163 9.497083980985963),-84.10919343002163,9.497083980985963
1371,40,68,129,237,POINT (-84.10919343002163 9.540947980985962),-84.10919343002163,9.540947980985962
1372,38,66,135,239,POINT (-84.10919343002163 9.584811980985961),-84.10919343002163,9.584811980985961
1373,30,52,136,218,POINT (-84.10919343002163 9.62867598098596),-84.10919343002163,9.62867598098596
1374,24,50,136,210,POINT (-84.10919343002163 9.67253998098596),-84.10919343002163,9.67253998098596
1375,19,38,138,195,POINT (-84.10919343002163 9.716403980985959),-84.10919343002163,9.716403980985959
1376,18,42,138,198,POINT (-84.10919343002163 9.760267980985958),-84.10919343002163,9.760267980985958
1377,17,42,139,198,POINT (-84.10919343002163 9.804131980985957),-84.10919343002163,9.804131980985957
1378,23,44,138,205,POINT (-84.10919343002163 9.847995980985957),-84.10919343002163,9.847995980985957
1379,22,44,136,202,POINT (-84.10919343002163 9.891859980985956),-84.10919343002163,9.891859980985956
1380,20,44,122,186,POINT (-84.10919343002163 9.935723980985955),-84.10919343002163,9.935723980985955
1381,20,49,121,190,POINT (-84.10919343002163 9.979587980985954),-84.10919343002163,9.979587980985954
1382,21,58,124,203,POINT (-84.10919343002163 10.023451980985953),-84.10919343002163,10.023451980985953
1383,23,60,128,211,POINT (-84.10919343002163 10.067315980985953),-84.10919343002163,10.067315980985953
1384,26,53,130,209,POINT (-84.10919343002163 10.111179980985952),-84.10919343002163,10.111179980985952
1385,26,52,132,210,POINT (-84.10919343002163 10.155043980985951),-84.10919343002163,10.155043980985951
1386,30,62,133,225,POINT (-84.10919343002163 10.19890798098595),-84.10919343002163,10.19890798098595
1387,30,65,141,236,POINT (-84.10919343002163 10.24277198098595),-84.10919343002163,10.24277198098595
1388,42,76,143,261,POINT (-84.10919343002163 10.286635980985949),-84.10919343002163,10.286635980985949
1389,47,82,144,273,POINT (-84.10919343002163 10.330499980985948),-84.10919343002163,10.330499980985948
1390,55,81,144,280,POINT (-84.10919343002163 10.374363980985947),-84.10919343002163,10.374363980985947
1391,52,78,144,274,POINT (-84.10919343002163 10.418227980985947),-84.10919343002163,10.418227980985947
1392,53,76,144,273,POINT (-84.10919343002163 10.462091980985946),-84.10919343002163,10.462091980985946
1393,50,73,144,267,POINT (-84.10919343002163 10.505955980985945),-84.10919343002163,10.505955980985945
1394,49,74,141,264,POINT (-84.10919343002163 10.549819980985944),-84.10919343002163,10.549819980985944
1395,44,74,140,258,POINT (-84.10919343002163 10.593683980985944),-84.10919343002163,10.593683980985944
1396,42,74,137,253,POINT (-84.10919343002163 10.637547980985943),-84.10919343002163,10.637547980985943
1397,43,75,136,254,POINT (-84.10919343002163 10.681411980985942),-84.10919343002163,10.681411980985942
1398,41,76,134,251,POINT (-84.10919343002163 10.725275980985941),-84.10919343002163,10.725275980985941
1399,40,75,130,245,POINT (-84.10919343002163 10.76913998098594),-84.10919343002163,10.76913998098594
1400,43,70,124,237,POINT (-84.07326143002163 9.409355980985964),-84.07326143002163,9.409355980985964
1401,44,70,124,238,POINT (-84.07326143002163 9.453219980985963),-84.07326143002163,9.453219980985963
1402,45,68,126,239,POINT (-84.07326143002163 9.497083980985963),-84.07326143002163,9.497083980985963
1403,40,65,131,236,POINT (-84.07326143002163 9.540947980985962),-84.07326143002163,9.540947980985962
1404,34,62,135,231,POINT (-84.07326143002163 9.584811980985961),-84.07326143002163,9.584811980985961
1405,30,45,133,208,POINT (-84.07326143002163 9.62867598098596),-84.07326143002163,9.62867598098596
1406,22,43,139,204,POINT (-84.07326143002163 9.67253998098596),-84.07326143002163,9.67253998098596
1407,17,38,138,193,POINT (-84.07326143002163 9.716403980985959),-84.07326143002163,9.716403980985959
1408,19,41,137,197,POINT (-84.07326143002163 9.760267980985958),-84.07326143002163,9.760267980985958
1409,18,43,137,198,POINT (-84.07326143002163 9.804131980985957),-84.07326143002163,9.804131980985957
1410,18,46,135,199,POINT (-84.07326143002163 9.847995980985957),-84.07326143002163,9.847995980985957
1411,21,43,130,194,POINT (-84.07326143002163 9.891859980985956),-84.07326143002163,9.891859980985956
1412,19,47,122,188,POINT (-84.07326143002163 9.935723980985955),-84.07326143002163,9.935723980985955
1413,19,53,122,194,POINT (-84.07326143002163 9.979587980985954),-84.07326143002163,9.979587980985954
1414,21,55,123,199,POINT (-84.07326143002163 10.023451980985953),-84.07326143002163,10.023451980985953
1415,26,57,128,211,POINT (-84.07326143002163 10.067315980985953),-84.07326143002163,10.067315980985953
1416,27,54,131,212,POINT (-84.07326143002163 10.111179980985952),-84.07326143002163,10.111179980985952
1417,30,61,132,223,POINT (-84.07326143002163 10.155043980985951),-84.07326143002163,10.155043980985951
1418,31,61,135,227,POINT (-84.07326143002163 10.19890798098595),-84.07326143002163,10.19890798098595
1419,33,68,139,240,POINT (-84.07326143002163 10.24277198098595),-84.07326143002163,10.24277198098595
1420,46,82,144,272,POINT (-84.07326143002163 10.286635980985949),-84.07326143002163,10.286635980985949
1421,54,83,145,282,POINT (-84.07326143002163 10.330499980985948),-84.07326143002163,10.330499980985948
1422,56,84,142,282,POINT (-84.07326143002163 10.374363980985947),-84.07326143002163,10.374363980985947
1423,55,81,145,281,POINT (-84.07326143002163 10.418227980985947),-84.07326143002163,10.418227980985947
1424,55,77,144,276,POINT (-84.07326143002163 10.462091980985946),-84.07326143002163,10.462091980985946
1425,50,74,143,267,POINT (-84.07326143002163 10.505955980985945),-84.07326143002163,10.505955980985945
1426,48,75,140,263,POINT (-84.07326143002163 10.549819980985944),-84.07326143002163,10.549819980985944
1427,43,77,139,259,POINT (-84.07326143002163 10.593683980985944),-84.07326143002163,10.593683980985944
1428,42,76,137,255,POINT (-84.07326143002163 10.637547980985943),-84.07326143002163,10.637547980985943
1429,42,77,138,257,POINT (-84.07326143002163 10.681411980985942),-84.07326143002163,10.681411980985942
1430,38,76,136,250,POINT (-84.07326143002163 10.725275980985941),-84.07326143002163,10.725275980985941
1431,44,67,123,234,POINT (-84.03732943002163 9.365491980985965),-84.03732943002163,9.365491980985965
1432,44,69,124,237,POINT (-84.03732943002163 9.409355980985964),-84.03732943002163,9.409355980985964
1433,45,69,125,239,POINT (-84.03732943002163 9.453219980985963),-84.03732943002163,9.453219980985963
1434,44,66,132,242,POINT (-84.03732943002163 9.497083980985963),-84.03732943002163,9.497083980985963
1435,43,64,131,238,POINT (-84.03732943002163 9.540947980985962),-84.03732943002163,9.540947980985962
1436,32,56,135,223,POINT (-84.03732943002163 9.584811980985961),-84.03732943002163,9.584811980985961
1437,25,46,141,212,POINT (-84.03732943002163 9.62867598098596),-84.03732943002163,9.62867598098596
1438,21,40,139,200,POINT (-84.03732943002163 9.67253998098596),-84.03732943002163,9.67253998098596
1439,19,36,136,191,POINT (-84.03732943002163 9.716403980985959),-84.03732943002163,9.716403980985959
1440,18,40,137,195,POINT (-84.03732943002163 9.760267980985958),-84.03732943002163,9.760267980985958
1441,19,43,136,198,POINT (-84.03732943002163 9.804131980985957),-84.03732943002163,9.804131980985957
1442,18,42,132,192,POINT (-84.03732943002163 9.847995980985957),-84.03732943002163,9.847995980985957
1443,19,47,122,188,POINT (-84.03732943002163 9.891859980985956),-84.03732943002163,9.891859980985956
1444,19,51,122,192,POINT (-84.03732943002163 9.935723980985955),-84.03732943002163,9.935723980985955
1445,18,56,125,199,POINT (-84.03732943002163 9.979587980985954),-84.03732943002163,9.979587980985954
1446,23,60,128,211,POINT (-84.03732943002163 10.023451980985953),-84.03732943002163,10.023451980985953
1447,32,55,130,217,POINT (-84.03732943002163 10.067315980985953),-84.03732943002163,10.067315980985953
1448,33,55,132,220,POINT (-84.03732943002163 10.111179980985952),-84.03732943002163,10.111179980985952
1449,32,63,134,229,POINT (-84.03732943002163 10.155043980985951),-84.03732943002163,10.155043980985951
1450,29,58,140,227,POINT (-84.03732943002163 10.19890798098595),-84.03732943002163,10.19890798098595
1451,43,73,141,257,POINT (-84.03732943002163 10.24277198098595),-84.03732943002163,10.24277198098595
1452,51,84,145,280,POINT (-84.03732943002163 10.286635980985949),-84.03732943002163,10.286635980985949
1453,55,85,143,283,POINT (-84.03732943002163 10.330499980985948),-84.03732943002163,10.330499980985948
1454,58,85,143,286,POINT (-84.03732943002163 10.374363980985947),-84.03732943002163,10.374363980985947
1455,59,84,146,289,POINT (-84.03732943002163 10.418227980985947),-84.03732943002163,10.418227980985947
1456,54,80,144,278,POINT (-84.03732943002163 10.462091980985946),-84.03732943002163,10.462091980985946
1457,50,76,143,269,POINT (-84.03732943002163 10.505955980985945),-84.03732943002163,10.505955980985945
1458,48,76,140,264,POINT (-84.03732943002163 10.549819980985944),-84.03732943002163,10.549819980985944
1459,44,77,140,261,POINT (-84.03732943002163 10.593683980985944),-84.03732943002163,10.593683980985944
1460,42,77,138,257,POINT (-84.03732943002163 10.637547980985943),-84.03732943002163,10.637547980985943
1461,41,77,138,256,POINT (-84.03732943002163 10.681411980985942),-84.03732943002163,10.681411980985942
1462,38,76,132,246,POINT (-84.03732943002163 10.725275980985941),-84.03732943002163,10.725275980985941
1463,44,66,125,235,POINT (-84.00139743002163 9.365491980985965),-84.00139743002163,9.365491980985965
1464,44,67,124,235,POINT (-84.00139743002163 9.409355980985964),-84.00139743002163,9.409355980985964
1465,46,65,128,239,POINT (-84.00139743002163 9.453219980985963),-84.00139743002163,9.453219980985963
1466,43,63,132,238,POINT (-84.00139743002163 9.497083980985963),-84.00139743002163,9.497083980985963
1467,38,57,135,230,POINT (-84.00139743002163 9.540947980985962),-84.00139743002163,9.540947980985962
1468,29,46,137,212,POINT (-84.00139743002163 9.584811980985961),-84.00139743002163,9.584811980985961
1469,20,41,139,200,POINT (-84.00139743002163 9.62867598098596),-84.00139743002163,9.62867598098596
1470,19,34,139,192,POINT (-84.00139743002163 9.67253998098596),-84.00139743002163,9.67253998098596
1471,20,32,138,190,POINT (-84.00139743002163 9.716403980985959),-84.00139743002163,9.716403980985959
1472,21,35,139,195,POINT (-84.00139743002163 9.760267980985958),-84.00139743002163,9.760267980985958
1473,19,39,134,192,POINT (-84.00139743002163 9.804131980985957),-84.00139743002163,9.804131980985957
1474,17,43,126,186,POINT (-84.00139743002163 9.847995980985957),-84.00139743002163,9.847995980985957
1475,18,45,124,187,POINT (-84.00139743002163 9.891859980985956),-84.00139743002163,9.891859980985956
1476,19,52,125,196,POINT (-84.00139743002163 9.935723980985955),-84.00139743002163,9.935723980985955
1477,18,56,128,202,POINT (-84.00139743002163 9.979587980985954),-84.00139743002163,9.979587980985954
1478,26,60,127,213,POINT (-84.00139743002163 10.023451980985953),-84.00139743002163,10.023451980985953
1479,36,58,132,226,POINT (-84.00139743002163 10.067315980985953),-84.00139743002163,10.067315980985953
1480,40,60,133,233,POINT (-84.00139743002163 10.111179980985952),-84.00139743002163,10.111179980985952
1481,38,63,134,235,POINT (-84.00139743002163 10.155043980985951),-84.00139743002163,10.155043980985951
1482,42,69,137,248,POINT (-84.00139743002163 10.19890798098595),-84.00139743002163,10.19890798098595
1483,51,78,141,270,POINT (-84.00139743002163 10.24277198098595),-84.00139743002163,10.24277198098595
1484,55,90,144,289,POINT (-84.00139743002163 10.286635980985949),-84.00139743002163,10.286635980985949
1485,56,89,144,289,POINT (-84.00139743002163 10.330499980985948),-84.00139743002163,10.330499980985948
1486,58,86,144,288,POINT (-84.00139743002163 10.374363980985947),-84.00139743002163,10.374363980985947
1487,60,83,145,288,POINT (-84.00139743002163 10.418227980985947),-84.00139743002163,10.418227980985947
1488,57,82,143,282,POINT (-84.00139743002163 10.462091980985946),-84.00139743002163,10.462091980985946
1489,51,77,140,268,POINT (-84.00139743002163 10.505955980985945),-84.00139743002163,10.505955980985945
1490,48,78,141,267,POINT (-84.00139743002163 10.549819980985944),-84.00139743002163,10.549819980985944
1491,43,77,139,259,POINT (-84.00139743002163 10.593683980985944),-84.00139743002163,10.593683980985944
1492,40,77,139,256,POINT (-84.00139743002163 10.637547980985943),-84.00139743002163,10.637547980985943
1493,41,78,137,256,POINT (-84.00139743002163 10.681411980985942),-84.00139743002163,10.681411980985942
1494,38,77,130,245,POINT (-84.00139743002163 10.725275980985941),-84.00139743002163,10.725275980985941
1495,45,51,122,218,POINT (-83.96546543002162 9.321627980985966),-83.96546543002162,9.321627980985966
1496,46,66,125,237,POINT (-83.96546543002162 9.365491980985965),-83.96546543002162,9.365491980985965
1497,46,68,126,240,POINT (-83.96546543002162 9.409355980985964),-83.96546543002162,9.409355980985964
1498,45,65,131,241,POINT (-83.96546543002162 9.453219980985963),-83.96546543002162,9.453219980985963
1499,41,62,132,235,POINT (-83.96546543002162 9.497083980985963),-83.96546543002162,9.497083980985963
1500,31,53,136,220,POINT (-83.96546543002162 9.540947980985962),-83.96546543002162,9.540947980985962
1501,26,41,140,207,POINT (-83.96546543002162 9.584811980985961),-83.96546543002162,9.584811980985961
1502,19,32,140,191,POINT (-83.96546543002162 9.62867598098596),-83.96546543002162,9.62867598098596
1503,16,32,138,186,POINT (-83.96546543002162 9.67253998098596),-83.96546543002162,9.67253998098596
1504,18,30,137,185,POINT (-83.96546543002162 9.716403980985959),-83.96546543002162,9.716403980985959
1505,21,34,139,194,POINT (-83.96546543002162 9.760267980985958),-83.96546543002162,9.760267980985958
1506,21,35,126,182,POINT (-83.96546543002162 9.804131980985957),-83.96546543002162,9.804131980985957
1507,20,45,125,190,POINT (-83.96546543002162 9.847995980985957),-83.96546543002162,9.847995980985957
1508,18,46,125,189,POINT (-83.96546543002162 9.891859980985956),-83.96546543002162,9.891859980985956
1509,14,49,130,193,POINT (-83.96546543002162 9.935723980985955),-83.96546543002162,9.935723980985955
1510,21,54,127,202,POINT (-83.96546543002162 9.979587980985954),-83.96546543002162,9.979587980985954
1511,26,54,129,209,POINT (-83.96546543002162 10.023451980985953),-83.96546543002162,10.023451980985953
1512,42,58,131,231,POINT (-83.96546543002162 10.067315980985953),-83.96546543002162,10.067315980985953
1513,43,64,130,237,POINT (-83.96546543002162 10.111179980985952),-83.96546543002162,10.111179980985952
1514,44,65,135,244,POINT (-83.96546543002162 10.155043980985951),-83.96546543002162,10.155043980985951
1515,47,80,137,264,POINT (-83.96546543002162 10.19890798098595),-83.96546543002162,10.19890798098595
1516,48,88,145,281,POINT (-83.96546543002162 10.24277198098595),-83.96546543002162,10.24277198098595
1517,56,89,145,290,POINT (-83.96546543002162 10.286635980985949),-83.96546543002162,10.286635980985949
1518,59,89,144,292,POINT (-83.96546543002162 10.330499980985948),-83.96546543002162,10.330499980985948
1519,60,89,144,293,POINT (-83.96546543002162 10.374363980985947),-83.96546543002162,10.374363980985947
1520,59,85,144,288,POINT (-83.96546543002162 10.418227980985947),-83.96546543002162,10.418227980985947
1521,56,81,143,280,POINT (-83.96546543002162 10.462091980985946),-83.96546543002162,10.462091980985946
1522,51,80,141,272,POINT (-83.96546543002162 10.505955980985945),-83.96546543002162,10.505955980985945
1523,49,79,141,269,POINT (-83.96546543002162 10.549819980985944),-83.96546543002162,10.549819980985944
1524,41,79,139,259,POINT (-83.96546543002162 10.593683980985944),-83.96546543002162,10.593683980985944
1525,40,80,137,257,POINT (-83.96546543002162 10.637547980985943),-83.96546543002162,10.637547980985943
1526,41,79,135,255,POINT (-83.96546543002162 10.681411980985942),-83.96546543002162,10.681411980985942
1527,39,76,129,244,POINT (-83.96546543002162 10.725275980985941),-83.96546543002162,10.725275980985941
1528,46,66,122,234,POINT (-83.92953343002162 9.321627980985966),-83.92953343002162,9.321627980985966
1529,46,67,123,236,POINT (-83.92953343002162 9.365491980985965),-83.92953343002162,9.365491980985965
1530,47,67,129,243,POINT (-83.92953343002162 9.409355980985964),-83.92953343002162,9.409355980985964
1531,45,63,131,239,POINT (-83.92953343002162 9.453219980985963),-83.92953343002162,9.453219980985963
1532,39,62,136,237,POINT (-83.92953343002162 9.497083980985963),-83.92953343002162,9.497083980985963
1533,31,45,138,214,POINT (-83.92953343002162 9.540947980985962),-83.92953343002162,9.540947980985962
1534,16,38,140,194,POINT (-83.92953343002162 9.584811980985961),-83.92953343002162,9.584811980985961
1535,11,29,138,178,POINT (-83.92953343002162 9.62867598098596),-83.92953343002162,9.62867598098596
1536,14,32,136,182,POINT (-83.92953343002162 9.67253998098596),-83.92953343002162,9.67253998098596
1537,19,30,137,186,POINT (-83.92953343002162 9.716403980985959),-83.92953343002162,9.716403980985959
1538,21,36,128,185,POINT (-83.92953343002162 9.760267980985958),-83.92953343002162,9.760267980985958
1539,22,37,128,187,POINT (-83.92953343002162 9.804131980985957),-83.92953343002162,9.804131980985957
1540,21,44,123,188,POINT (-83.92953343002162 9.847995980985957),-83.92953343002162,9.847995980985957
1541,17,47,126,190,POINT (-83.92953343002162 9.891859980985956),-83.92953343002162,9.891859980985956
1542,17,48,129,194,POINT (-83.92953343002162 9.935723980985955),-83.92953343002162,9.935723980985955
1543,20,50,128,198,POINT (-83.92953343002162 9.979587980985954),-83.92953343002162,9.979587980985954
1544,29,51,131,211,POINT (-83.92953343002162 10.023451980985953),-83.92953343002162,10.023451980985953
1545,37,55,134,226,POINT (-83.92953343002162 10.067315980985953),-83.92953343002162,10.067315980985953
1546,44,63,131,238,POINT (-83.92953343002162 10.111179980985952),-83.92953343002162,10.111179980985952
1547,46,70,135,251,POINT (-83.92953343002162 10.155043980985951),-83.92953343002162,10.155043980985951
1548,50,90,137,277,POINT (-83.92953343002162 10.19890798098595),-83.92953343002162,10.19890798098595
1549,53,91,145,289,POINT (-83.92953343002162 10.24277198098595),-83.92953343002162,10.24277198098595
1550,57,91,144,292,POINT (-83.92953343002162 10.286635980985949),-83.92953343002162,10.286635980985949
1551,59,88,142,289,POINT (-83.92953343002162 10.330499980985948),-83.92953343002162,10.330499980985948
1552,60,89,142,291,POINT (-83.92953343002162 10.374363980985947),-83.92953343002162,10.374363980985947
1553,58,85,141,284,POINT (-83.92953343002162 10.418227980985947),-83.92953343002162,10.418227980985947
1554,56,84,141,281,POINT (-83.92953343002162 10.462091980985946),-83.92953343002162,10.462091980985946
1555,50,81,140,271,POINT (-83.92953343002162 10.505955980985945),-83.92953343002162,10.505955980985945
1556,46,79,139,264,POINT (-83.92953343002162 10.549819980985944),-83.92953343002162,10.549819980985944
1557,43,78,138,259,POINT (-83.92953343002162 10.593683980985944),-83.92953343002162,10.593683980985944
1558,41,79,137,257,POINT (-83.92953343002162 10.637547980985943),-83.92953343002162,10.637547980985943
1559,40,78,132,250,POINT (-83.92953343002162 10.681411980985942),-83.92953343002162,10.681411980985942
1560,41,76,129,246,POINT (-83.92953343002162 10.725275980985941),-83.92953343002162,10.725275980985941
1561,47,63,120,230,POINT (-83.89360143002162 9.277763980985966),-83.89360143002162,9.277763980985966
1562,49,68,122,239,POINT (-83.89360143002162 9.321627980985966),-83.89360143002162,9.321627980985966
1563,47,68,127,242,POINT (-83.89360143002162 9.365491980985965),-83.89360143002162,9.365491980985965
1564,47,63,132,242,POINT (-83.89360143002162 9.409355980985964),-83.89360143002162,9.409355980985964
1565,40,60,133,233,POINT (-83.89360143002162 9.453219980985963),-83.89360143002162,9.453219980985963
1566,32,55,136,223,POINT (-83.89360143002162 9.497083980985963),-83.89360143002162,9.497083980985963
1567,23,40,142,205,POINT (-83.89360143002162 9.540947980985962),-83.89360143002162,9.540947980985962
1568,12,31,139,182,POINT (-83.89360143002162 9.584811980985961),-83.89360143002162,9.584811980985961
1569,13,30,138,181,POINT (-83.89360143002162 9.62867598098596),-83.89360143002162,9.62867598098596
1570,15,29,137,181,POINT (-83.89360143002162 9.67253998098596),-83.89360143002162,9.67253998098596
1571,19,32,133,184,POINT (-83.89360143002162 9.716403980985959),-83.89360143002162,9.716403980985959
1572,20,34,127,181,POINT (-83.89360143002162 9.760267980985958),-83.89360143002162,9.760267980985958
1573,23,39,126,188,POINT (-83.89360143002162 9.804131980985957),-83.89360143002162,9.804131980985957
1574,23,41,126,190,POINT (-83.89360143002162 9.847995980985957),-83.89360143002162,9.847995980985957
1575,17,42,128,187,POINT (-83.89360143002162 9.891859980985956),-83.89360143002162,9.891859980985956
1576,18,45,126,189,POINT (-83.89360143002162 9.935723980985955),-83.89360143002162,9.935723980985955
1577,22,48,130,200,POINT (-83.89360143002162 9.979587980985954),-83.89360143002162,9.979587980985954
1578,25,52,133,210,POINT (-83.89360143002162 10.023451980985953),-83.89360143002162,10.023451980985953
1579,34,59,135,228,POINT (-83.89360143002162 10.067315980985953),-83.89360143002162,10.067315980985953
1580,44,68,132,244,POINT (-83.89360143002162 10.111179980985952),-83.89360143002162,10.111179980985952
1581,47,77,135,259,POINT (-83.89360143002162 10.155043980985951),-83.89360143002162,10.155043980985951
1582,49,87,144,280,POINT (-83.89360143002162 10.19890798098595),-83.89360143002162,10.19890798098595
1583,56,91,144,291,POINT (-83.89360143002162 10.24277198098595),-83.89360143002162,10.24277198098595
1584,58,92,142,292,POINT (-83.89360143002162 10.286635980985949),-83.89360143002162,10.286635980985949
1585,59,90,142,291,POINT (-83.89360143002162 10.330499980985948),-83.89360143002162,10.330499980985948
1586,56,91,142,289,POINT (-83.89360143002162 10.374363980985947),-83.89360143002162,10.374363980985947
1587,53,87,140,280,POINT (-83.89360143002162 10.418227980985947),-83.89360143002162,10.418227980985947
1588,52,82,140,274,POINT (-83.89360143002162 10.462091980985946),-83.89360143002162,10.462091980985946
1589,50,81,140,271,POINT (-83.89360143002162 10.505955980985945),-83.89360143002162,10.505955980985945
1590,45,80,137,262,POINT (-83.89360143002162 10.549819980985944),-83.89360143002162,10.549819980985944
1591,44,78,137,259,POINT (-83.89360143002162 10.593683980985944),-83.89360143002162,10.593683980985944
1592,41,78,135,254,POINT (-83.89360143002162 10.637547980985943),-83.89360143002162,10.637547980985943
1593,39,77,128,244,POINT (-83.89360143002162 10.681411980985942),-83.89360143002162,10.681411980985942
1594,39,76,128,243,POINT (-83.89360143002162 10.725275980985941),-83.89360143002162,10.725275980985941
1595,50,67,122,239,POINT (-83.85766943002162 9.277763980985966),-83.85766943002162,9.277763980985966
1596,50,69,123,242,POINT (-83.85766943002162 9.321627980985966),-83.85766943002162,9.321627980985966
1597,50,68,130,248,POINT (-83.85766943002162 9.365491980985965),-83.85766943002162,9.365491980985965
1598,48,61,132,241,POINT (-83.85766943002162 9.409355980985964),-83.85766943002162,9.409355980985964
1599,37,60,136,233,POINT (-83.85766943002162 9.453219980985963),-83.85766943002162,9.453219980985963
1600,29,44,138,211,POINT (-83.85766943002162 9.497083980985963),-83.85766943002162,9.497083980985963
1601,18,42,138,198,POINT (-83.85766943002162 9.540947980985962),-83.85766943002162,9.540947980985962
1602,12,30,138,180,POINT (-83.85766943002162 9.584811980985961),-83.85766943002162,9.584811980985961
1603,16,29,136,181,POINT (-83.85766943002162 9.62867598098596),-83.85766943002162,9.62867598098596
1604,17,30,133,180,POINT (-83.85766943002162 9.67253998098596),-83.85766943002162,9.67253998098596
1605,17,28,127,172,POINT (-83.85766943002162 9.716403980985959),-83.85766943002162,9.716403980985959
1606,22,35,127,184,POINT (-83.85766943002162 9.760267980985958),-83.85766943002162,9.760267980985958
1607,26,36,124,186,POINT (-83.85766943002162 9.804131980985957),-83.85766943002162,9.804131980985957
1608,25,40,127,192,POINT (-83.85766943002162 9.847995980985957),-83.85766943002162,9.847995980985957
1609,22,43,126,191,POINT (-83.85766943002162 9.891859980985956),-83.85766943002162,9.891859980985956
1610,19,46,129,194,POINT (-83.85766943002162 9.935723980985955),-83.85766943002162,9.935723980985955
1611,18,46,131,195,POINT (-83.85766943002162 9.979587980985954),-83.85766943002162,9.979587980985954
1612,21,54,133,208,POINT (-83.85766943002162 10.023451980985953),-83.85766943002162,10.023451980985953
1613,32,60,133,225,POINT (-83.85766943002162 10.067315980985953),-83.85766943002162,10.067315980985953
1614,44,73,137,254,POINT (-83.85766943002162 10.111179980985952),-83.85766943002162,10.111179980985952
1615,48,80,139,267,POINT (-83.85766943002162 10.155043980985951),-83.85766943002162,10.155043980985951
1616,56,91,143,290,POINT (-83.85766943002162 10.19890798098595),-83.85766943002162,10.19890798098595
1617,58,93,144,295,POINT (-83.85766943002162 10.24277198098595),-83.85766943002162,10.24277198098595
1618,60,91,142,293,POINT (-83.85766943002162 10.286635980985949),-83.85766943002162,10.286635980985949
1619,58,90,142,290,POINT (-83.85766943002162 10.330499980985948),-83.85766943002162,10.330499980985948
1620,55,90,140,285,POINT (-83.85766943002162 10.374363980985947),-83.85766943002162,10.374363980985947
1621,52,86,141,279,POINT (-83.85766943002162 10.418227980985947),-83.85766943002162,10.418227980985947
1622,52,83,141,276,POINT (-83.85766943002162 10.462091980985946),-83.85766943002162,10.462091980985946
1623,49,81,138,268,POINT (-83.85766943002162 10.505955980985945),-83.85766943002162,10.505955980985945
1624,46,80,136,262,POINT (-83.85766943002162 10.549819980985944),-83.85766943002162,10.549819980985944
1625,44,78,135,257,POINT (-83.85766943002162 10.593683980985944),-83.85766943002162,10.593683980985944
1626,41,77,132,250,POINT (-83.85766943002162 10.637547980985943),-83.85766943002162,10.637547980985943
1627,40,77,130,247,POINT (-83.85766943002162 10.681411980985942),-83.85766943002162,10.681411980985942
1628,39,76,126,241,POINT (-83.85766943002162 10.725275980985941),-83.85766943002162,10.725275980985941
1629,50,67,121,238,POINT (-83.82173743002161 9.233899980985967),-83.82173743002161,9.233899980985967
1630,55,68,123,246,POINT (-83.82173743002161 9.277763980985966),-83.82173743002161,9.277763980985966
1631,54,68,126,248,POINT (-83.82173743002161 9.321627980985966),-83.82173743002161,9.321627980985966
1632,53,67,135,255,POINT (-83.82173743002161 9.365491980985965),-83.82173743002161,9.365491980985965
1633,44,59,137,240,POINT (-83.82173743002161 9.409355980985964),-83.82173743002161,9.409355980985964
1634,32,60,138,230,POINT (-83.82173743002161 9.453219980985963),-83.82173743002161,9.453219980985963
1635,29,43,140,212,POINT (-83.82173743002161 9.497083980985963),-83.82173743002161,9.497083980985963
1636,13,38,138,189,POINT (-83.82173743002161 9.540947980985962),-83.82173743002161,9.540947980985962
1637,14,29,136,179,POINT (-83.82173743002161 9.584811980985961),-83.82173743002161,9.584811980985961
1638,15,30,135,180,POINT (-83.82173743002161 9.62867598098596),-83.82173743002161,9.62867598098596
1639,17,28,128,173,POINT (-83.82173743002161 9.67253998098596),-83.82173743002161,9.67253998098596
1640,17,30,124,171,POINT (-83.82173743002161 9.716403980985959),-83.82173743002161,9.716403980985959
1641,31,32,125,188,POINT (-83.82173743002161 9.760267980985958),-83.82173743002161,9.760267980985958
1642,37,35,125,197,POINT (-83.82173743002161 9.804131980985957),-83.82173743002161,9.804131980985957
1643,37,41,129,207,POINT (-83.82173743002161 9.847995980985957),-83.82173743002161,9.847995980985957
1644,29,43,128,200,POINT (-83.82173743002161 9.891859980985956),-83.82173743002161,9.891859980985956
1645,17,44,129,190,POINT (-83.82173743002161 9.935723980985955),-83.82173743002161,9.935723980985955
1646,20,47,132,199,POINT (-83.82173743002161 9.979587980985954),-83.82173743002161,9.979587980985954
1647,19,56,132,207,POINT (-83.82173743002161 10.023451980985953),-83.82173743002161,10.023451980985953
1648,27,64,135,226,POINT (-83.82173743002161 10.067315980985953),-83.82173743002161,10.067315980985953
1649,43,78,135,256,POINT (-83.82173743002161 10.111179980985952),-83.82173743002161,10.111179980985952
1650,51,89,142,282,POINT (-83.82173743002161 10.155043980985951),-83.82173743002161,10.155043980985951
1651,58,90,144,292,POINT (-83.82173743002161 10.19890798098595),-83.82173743002161,10.19890798098595
1652,60,91,142,293,POINT (-83.82173743002161 10.24277198098595),-83.82173743002161,10.24277198098595
1653,59,89,141,289,POINT (-83.82173743002161 10.286635980985949),-83.82173743002161,10.286635980985949
1654,56,90,142,288,POINT (-83.82173743002161 10.330499980985948),-83.82173743002161,10.330499980985948
1655,53,89,141,283,POINT (-83.82173743002161 10.374363980985947),-83.82173743002161,10.374363980985947
1656,52,85,141,278,POINT (-83.82173743002161 10.418227980985947),-83.82173743002161,10.418227980985947
1657,50,82,140,272,POINT (-83.82173743002161 10.462091980985946),-83.82173743002161,10.462091980985946
1658,49,81,137,267,POINT (-83.82173743002161 10.505955980985945),-83.82173743002161,10.505955980985945
1659,47,81,135,263,POINT (-83.82173743002161 10.549819980985944),-83.82173743002161,10.549819980985944
1660,44,77,136,257,POINT (-83.82173743002161 10.593683980985944),-83.82173743002161,10.593683980985944
1661,41,78,133,252,POINT (-83.82173743002161 10.637547980985943),-83.82173743002161,10.637547980985943
1662,40,77,129,246,POINT (-83.82173743002161 10.681411980985942),-83.82173743002161,10.681411980985942
1663,40,77,127,244,POINT (-83.82173743002161 10.725275980985941),-83.82173743002161,10.725275980985941
1664,41,77,124,242,POINT (-83.82173743002161 10.76913998098594),-83.82173743002161,10.76913998098594
1665,0,7,26,33,POINT (-83.78580543002161 9.190035980985968),-83.78580543002161,9.190035980985968
1666,53,69,122,244,POINT (-83.78580543002161 9.233899980985967),-83.78580543002161,9.233899980985967
1667,56,69,125,250,POINT (-83.78580543002161 9.277763980985966),-83.78580543002161,9.277763980985966
1668,57,69,135,261,POINT (-83.78580543002161 9.321627980985966),-83.78580543002161,9.321627980985966
1669,51,63,136,250,POINT (-83.78580543002161 9.365491980985965),-83.78580543002161,9.365491980985965
1670,41,61,137,239,POINT (-83.78580543002161 9.409355980985964),-83.78580543002161,9.409355980985964
1671,32,56,138,226,POINT (-83.78580543002161 9.453219980985963),-83.78580543002161,9.453219980985963
1672,22,40,139,201,POINT (-83.78580543002161 9.497083980985963),-83.78580543002161,9.497083980985963
1673,13,33,138,184,POINT (-83.78580543002161 9.540947980985962),-83.78580543002161,9.540947980985962
1674,14,28,135,177,POINT (-83.78580543002161 9.584811980985961),-83.78580543002161,9.584811980985961
1675,15,27,129,171,POINT (-83.78580543002161 9.62867598098596),-83.78580543002161,9.62867598098596
1676,14,27,124,165,POINT (-83.78580543002161 9.67253998098596),-83.78580543002161,9.67253998098596
1677,29,31,124,184,POINT (-83.78580543002161 9.716403980985959),-83.78580543002161,9.716403980985959
1678,36,35,123,194,POINT (-83.78580543002161 9.760267980985958),-83.78580543002161,9.760267980985958
1679,42,37,127,206,POINT (-83.78580543002161 9.804131980985957),-83.78580543002161,9.804131980985957
1680,46,40,126,212,POINT (-83.78580543002161 9.847995980985957),-83.78580543002161,9.847995980985957
1681,36,45,127,208,POINT (-83.78580543002161 9.891859980985956),-83.78580543002161,9.891859980985956
1682,24,45,131,200,POINT (-83.78580543002161 9.935723980985955),-83.78580543002161,9.935723980985955
1683,20,47,131,198,POINT (-83.78580543002161 9.979587980985954),-83.78580543002161,9.979587980985954
1684,22,60,134,216,POINT (-83.78580543002161 10.023451980985953),-83.78580543002161,10.023451980985953
1685,26,67,137,230,POINT (-83.78580543002161 10.067315980985953),-83.78580543002161,10.067315980985953
1686,42,77,138,257,POINT (-83.78580543002161 10.111179980985952),-83.78580543002161,10.111179980985952
1687,60,89,143,292,POINT (-83.78580543002161 10.155043980985951),-83.78580543002161,10.155043980985951
1688,59,88,144,291,POINT (-83.78580543002161 10.19890798098595),-83.78580543002161,10.19890798098595
1689,59,91,139,289,POINT (-83.78580543002161 10.24277198098595),-83.78580543002161,10.24277198098595
1690,58,90,142,290,POINT (-83.78580543002161 10.286635980985949),-83.78580543002161,10.286635980985949
1691,54,90,140,284,POINT (-83.78580543002161 10.330499980985948),-83.78580543002161,10.330499980985948
1692,52,87,141,280,POINT (-83.78580543002161 10.374363980985947),-83.78580543002161,10.374363980985947
1693,52,85,140,277,POINT (-83.78580543002161 10.418227980985947),-83.78580543002161,10.418227980985947
1694,49,82,138,269,POINT (-83.78580543002161 10.462091980985946),-83.78580543002161,10.462091980985946
1695,47,81,135,263,POINT (-83.78580543002161 10.505955980985945),-83.78580543002161,10.505955980985945
1696,45,81,136,262,POINT (-83.78580543002161 10.549819980985944),-83.78580543002161,10.549819980985944
1697,43,77,132,252,POINT (-83.78580543002161 10.593683980985944),-83.78580543002161,10.593683980985944
1698,41,79,131,251,POINT (-83.78580543002161 10.637547980985943),-83.78580543002161,10.637547980985943
1699,40,78,127,245,POINT (-83.78580543002161 10.681411980985942),-83.78580543002161,10.681411980985942
1700,39,77,126,242,POINT (-83.78580543002161 10.725275980985941),-83.78580543002161,10.725275980985941
1701,38,77,123,238,POINT (-83.78580543002161 10.76913998098594),-83.78580543002161,10.76913998098594
1702,41,78,122,241,POINT (-83.78580543002161 10.81300398098594),-83.78580543002161,10.81300398098594
1703,51,69,122,242,POINT (-83.74987343002161 9.190035980985968),-83.74987343002161,9.190035980985968
1704,54,74,126,254,POINT (-83.74987343002161 9.233899980985967),-83.74987343002161,9.233899980985967
1705,57,70,133,260,POINT (-83.74987343002161 9.277763980985966),-83.74987343002161,9.277763980985966
1706,54,67,134,255,POINT (-83.74987343002161 9.321627980985966),-83.74987343002161,9.321627980985966
1707,49,65,135,249,POINT (-83.74987343002161 9.365491980985965),-83.74987343002161,9.365491980985965
1708,37,63,136,236,POINT (-83.74987343002161 9.409355980985964),-83.74987343002161,9.409355980985964
1709,29,50,140,219,POINT (-83.74987343002161 9.453219980985963),-83.74987343002161,9.453219980985963
1710,17,36,142,195,POINT (-83.74987343002161 9.497083980985963),-83.74987343002161,9.497083980985963
1711,15,29,137,181,POINT (-83.74987343002161 9.540947980985962),-83.74987343002161,9.540947980985962
1712,14,26,129,169,POINT (-83.74987343002161 9.584811980985961),-83.74987343002161,9.584811980985961
1713,15,24,124,163,POINT (-83.74987343002161 9.62867598098596),-83.74987343002161,9.62867598098596
1714,18,26,122,166,POINT (-83.74987343002161 9.67253998098596),-83.74987343002161,9.67253998098596
1715,25,29,124,178,POINT (-83.74987343002161 9.716403980985959),-83.74987343002161,9.716403980985959
1716,37,35,123,195,POINT (-83.74987343002161 9.760267980985958),-83.74987343002161,9.760267980985958
1717,49,37,124,210,POINT (-83.74987343002161 9.804131980985957),-83.74987343002161,9.804131980985957
1718,54,40,123,217,POINT (-83.74987343002161 9.847995980985957),-83.74987343002161,9.847995980985957
1719,56,43,125,224,POINT (-83.74987343002161 9.891859980985956),-83.74987343002161,9.891859980985956
1720,34,47,131,212,POINT (-83.74987343002161 9.935723980985955),-83.74987343002161,9.935723980985955
1721,21,54,134,209,POINT (-83.74987343002161 9.979587980985954),-83.74987343002161,9.979587980985954
1722,20,59,135,214,POINT (-83.74987343002161 10.023451980985953),-83.74987343002161,10.023451980985953
1723,24,62,138,224,POINT (-83.74987343002161 10.067315980985953),-83.74987343002161,10.067315980985953
1724,46,83,144,273,POINT (-83.74987343002161 10.111179980985952),-83.74987343002161,10.111179980985952
1725,61,87,143,291,POINT (-83.74987343002161 10.155043980985951),-83.74987343002161,10.155043980985951
1726,62,90,143,295,POINT (-83.74987343002161 10.19890798098595),-83.74987343002161,10.19890798098595
1727,59,91,142,292,POINT (-83.74987343002161 10.24277198098595),-83.74987343002161,10.24277198098595
1728,57,89,140,286,POINT (-83.74987343002161 10.286635980985949),-83.74987343002161,10.286635980985949
1729,53,88,140,281,POINT (-83.74987343002161 10.330499980985948),-83.74987343002161,10.330499980985948
1730,52,87,140,279,POINT (-83.74987343002161 10.374363980985947),-83.74987343002161,10.374363980985947
1731,51,84,139,274,POINT (-83.74987343002161 10.418227980985947),-83.74987343002161,10.418227980985947
1732,49,81,135,265,POINT (-83.74987343002161 10.462091980985946),-83.74987343002161,10.462091980985946
1733,46,81,135,262,POINT (-83.74987343002161 10.505955980985945),-83.74987343002161,10.505955980985945
1734,45,80,133,258,POINT (-83.74987343002161 10.549819980985944),-83.74987343002161,10.549819980985944
1735,44,78,132,254,POINT (-83.74987343002161 10.593683980985944),-83.74987343002161,10.593683980985944
1736,40,79,129,248,POINT (-83.74987343002161 10.637547980985943),-83.74987343002161,10.637547980985943
1737,39,79,127,245,POINT (-83.74987343002161 10.681411980985942),-83.74987343002161,10.681411980985942
1738,40,77,125,242,POINT (-83.74987343002161 10.725275980985941),-83.74987343002161,10.725275980985941
1739,39,77,121,237,POINT (-83.74987343002161 10.76913998098594),-83.74987343002161,10.76913998098594
1740,41,78,121,240,POINT (-83.74987343002161 10.81300398098594),-83.74987343002161,10.81300398098594
1741,49,69,123,241,POINT (-83.7139414300216 9.146171980985969),-83.7139414300216,9.146171980985969
1742,52,71,126,249,POINT (-83.7139414300216 9.190035980985968),-83.7139414300216,9.190035980985968
1743,53,70,130,253,POINT (-83.7139414300216 9.233899980985967),-83.7139414300216,9.233899980985967
1744,56,71,134,261,POINT (-83.7139414300216 9.277763980985966),-83.7139414300216,9.277763980985966
1745,53,68,134,255,POINT (-83.7139414300216 9.321627980985966),-83.7139414300216,9.321627980985966
1746,43,66,135,244,POINT (-83.7139414300216 9.365491980985965),-83.7139414300216,9.365491980985965
1747,33,57,138,228,POINT (-83.7139414300216 9.409355980985964),-83.7139414300216,9.409355980985964
1748,22,38,140,200,POINT (-83.7139414300216 9.453219980985963),-83.7139414300216,9.453219980985963
1749,15,31,139,185,POINT (-83.7139414300216 9.497083980985963),-83.7139414300216,9.497083980985963
1750,14,27,133,174,POINT (-83.7139414300216 9.540947980985962),-83.7139414300216,9.540947980985962
1751,13,25,124,162,POINT (-83.7139414300216 9.584811980985961),-83.7139414300216,9.584811980985961
1752,13,22,123,158,POINT (-83.7139414300216 9.62867598098596),-83.7139414300216,9.62867598098596
1753,15,23,121,159,POINT (-83.7139414300216 9.67253998098596),-83.7139414300216,9.67253998098596
1754,27,30,125,182,POINT (-83.7139414300216 9.716403980985959),-83.7139414300216,9.716403980985959
1755,39,37,123,199,POINT (-83.7139414300216 9.760267980985958),-83.7139414300216,9.760267980985958
1756,53,40,121,214,POINT (-83.7139414300216 9.804131980985957),-83.7139414300216,9.804131980985957
1757,56,45,119,220,POINT (-83.7139414300216 9.847995980985957),-83.7139414300216,9.847995980985957
1758,57,46,126,229,POINT (-83.7139414300216 9.891859980985956),-83.7139414300216,9.891859980985956
1759,53,54,125,232,POINT (-83.7139414300216 9.935723980985955),-83.7139414300216,9.935723980985955
1760,32,60,133,225,POINT (-83.7139414300216 9.979587980985954),-83.7139414300216,9.979587980985954
1761,18,61,133,212,POINT (-83.7139414300216 10.023451980985953),-83.7139414300216,10.023451980985953
1762,30,66,144,240,POINT (-83.7139414300216 10.067315980985953),-83.7139414300216,10.067315980985953
1763,57,86,142,285,POINT (-83.7139414300216 10.111179980985952),-83.7139414300216,10.111179980985952
1764,61,86,141,288,POINT (-83.7139414300216 10.155043980985951),-83.7139414300216,10.155043980985951
1765,61,90,140,291,POINT (-83.7139414300216 10.19890798098595),-83.7139414300216,10.19890798098595
1766,58,87,140,285,POINT (-83.7139414300216 10.24277198098595),-83.7139414300216,10.24277198098595
1767,54,88,139,281,POINT (-83.7139414300216 10.286635980985949),-83.7139414300216,10.286635980985949
1768,53,88,139,280,POINT (-83.7139414300216 10.330499980985948),-83.7139414300216,10.330499980985948
1769,53,86,139,278,POINT (-83.7139414300216 10.374363980985947),-83.7139414300216,10.374363980985947
1770,49,85,137,271,POINT (-83.7139414300216 10.418227980985947),-83.7139414300216,10.418227980985947
1771,48,81,134,263,POINT (-83.7139414300216 10.462091980985946),-83.7139414300216,10.462091980985946
1772,46,81,134,261,POINT (-83.7139414300216 10.505955980985945),-83.7139414300216,10.505955980985945
1773,45,80,130,255,POINT (-83.7139414300216 10.549819980985944),-83.7139414300216,10.549819980985944
1774,46,78,129,253,POINT (-83.7139414300216 10.593683980985944),-83.7139414300216,10.593683980985944
1775,40,79,125,244,POINT (-83.7139414300216 10.637547980985943),-83.7139414300216,10.637547980985943
1776,38,79,125,242,POINT (-83.7139414300216 10.681411980985942),-83.7139414300216,10.681411980985942
1777,38,77,124,239,POINT (-83.7139414300216 10.725275980985941),-83.7139414300216,10.725275980985941
1778,34,77,122,233,POINT (-83.7139414300216 10.76913998098594),-83.7139414300216,10.76913998098594
1779,36,77,119,232,POINT (-83.7139414300216 10.81300398098594),-83.7139414300216,10.81300398098594
1780,33,76,119,228,POINT (-83.7139414300216 10.856867980985939),-83.7139414300216,10.856867980985939
1781,47,74,122,243,POINT (-83.6780094300216 8.663667980985977),-83.6780094300216,8.663667980985977
1782,49,69,123,241,POINT (-83.6780094300216 9.10230798098597),-83.6780094300216,9.10230798098597
1783,53,73,126,252,POINT (-83.6780094300216 9.146171980985969),-83.6780094300216,9.146171980985969
1784,52,72,130,254,POINT (-83.6780094300216 9.190035980985968),-83.6780094300216,9.190035980985968
1785,51,72,134,257,POINT (-83.6780094300216 9.233899980985967),-83.6780094300216,9.233899980985967
1786,54,70,135,259,POINT (-83.6780094300216 9.277763980985966),-83.6780094300216,9.277763980985966
1787,48,67,132,247,POINT (-83.6780094300216 9.321627980985966),-83.6780094300216,9.321627980985966
1788,40,64,137,241,POINT (-83.6780094300216 9.365491980985965),-83.6780094300216,9.365491980985965
1789,30,51,135,216,POINT (-83.6780094300216 9.409355980985964),-83.6780094300216,9.409355980985964
1790,19,33,142,194,POINT (-83.6780094300216 9.453219980985963),-83.6780094300216,9.453219980985963
1791,16,33,134,183,POINT (-83.6780094300216 9.497083980985963),-83.6780094300216,9.497083980985963
1792,12,25,127,164,POINT (-83.6780094300216 9.540947980985962),-83.6780094300216,9.540947980985962
1793,13,22,124,159,POINT (-83.6780094300216 9.584811980985961),-83.6780094300216,9.584811980985961
1794,11,22,124,157,POINT (-83.6780094300216 9.62867598098596),-83.6780094300216,9.62867598098596
1795,15,22,124,161,POINT (-83.6780094300216 9.67253998098596),-83.6780094300216,9.67253998098596
1796,26,29,124,179,POINT (-83.6780094300216 9.716403980985959),-83.6780094300216,9.716403980985959
1797,42,35,124,201,POINT (-83.6780094300216 9.760267980985958),-83.6780094300216,9.760267980985958
1798,52,39,120,211,POINT (-83.6780094300216 9.804131980985957),-83.6780094300216,9.804131980985957
1799,57,46,122,225,POINT (-83.6780094300216 9.847995980985957),-83.6780094300216,9.847995980985957
1800,59,53,124,236,POINT (-83.6780094300216 9.891859980985956),-83.6780094300216,9.891859980985956
1801,56,57,126,239,POINT (-83.6780094300216 9.935723980985955),-83.6780094300216,9.935723980985955
1802,48,64,129,241,POINT (-83.6780094300216 9.979587980985954),-83.6780094300216,9.979587980985954
1803,37,62,140,239,POINT (-83.6780094300216 10.023451980985953),-83.6780094300216,10.023451980985953
1804,45,77,141,263,POINT (-83.6780094300216 10.067315980985953),-83.6780094300216,10.067315980985953
1805,66,85,140,291,POINT (-83.6780094300216 10.111179980985952),-83.6780094300216,10.111179980985952
1806,62,88,142,292,POINT (-83.6780094300216 10.155043980985951),-83.6780094300216,10.155043980985951
1807,60,90,139,289,POINT (-83.6780094300216 10.19890798098595),-83.6780094300216,10.19890798098595
1808,57,87,139,283,POINT (-83.6780094300216 10.24277198098595),-83.6780094300216,10.24277198098595
1809,53,88,138,279,POINT (-83.6780094300216 10.286635980985949),-83.6780094300216,10.286635980985949
1810,53,88,138,279,POINT (-83.6780094300216 10.330499980985948),-83.6780094300216,10.330499980985948
1811,51,85,138,274,POINT (-83.6780094300216 10.374363980985947),-83.6780094300216,10.374363980985947
1812,48,84,136,268,POINT (-83.6780094300216 10.418227980985947),-83.6780094300216,10.418227980985947
1813,47,84,133,264,POINT (-83.6780094300216 10.462091980985946),-83.6780094300216,10.462091980985946
1814,45,81,130,256,POINT (-83.6780094300216 10.505955980985945),-83.6780094300216,10.505955980985945
1815,46,81,128,255,POINT (-83.6780094300216 10.549819980985944),-83.6780094300216,10.549819980985944
1816,45,81,128,254,POINT (-83.6780094300216 10.593683980985944),-83.6780094300216,10.593683980985944
1817,39,81,125,245,POINT (-83.6780094300216 10.637547980985943),-83.6780094300216,10.637547980985943
1818,37,81,125,243,POINT (-83.6780094300216 10.681411980985942),-83.6780094300216,10.681411980985942
1819,36,76,123,235,POINT (-83.6780094300216 10.725275980985941),-83.6780094300216,10.725275980985941
1820,36,75,122,233,POINT (-83.6780094300216 10.76913998098594),-83.6780094300216,10.76913998098594
1821,32,75,120,227,POINT (-83.6780094300216 10.81300398098594),-83.6780094300216,10.81300398098594
1822,31,77,119,227,POINT (-83.6780094300216 10.856867980985939),-83.6780094300216,10.856867980985939
1823,31,75,117,223,POINT (-83.6780094300216 10.900731980985938),-83.6780094300216,10.900731980985938
1824,47,74,123,244,POINT (-83.6420774300216 8.619803980985978),-83.6420774300216,8.619803980985978
1825,47,74,123,244,POINT (-83.6420774300216 8.663667980985977),-83.6420774300216,8.663667980985977
1826,47,73,122,242,POINT (-83.6420774300216 8.707531980985976),-83.6420774300216,8.707531980985976
1827,47,17,121,185,POINT (-83.6420774300216 8.751395980985976),-83.6420774300216,8.751395980985976
1828,52,74,125,251,POINT (-83.6420774300216 9.10230798098597),-83.6420774300216,9.10230798098597
1829,52,73,131,256,POINT (-83.6420774300216 9.146171980985969),-83.6420774300216,9.146171980985969
1830,52,72,136,260,POINT (-83.6420774300216 9.190035980985968),-83.6420774300216,9.190035980985968
1831,53,71,134,258,POINT (-83.6420774300216 9.233899980985967),-83.6420774300216,9.233899980985967
1832,49,68,131,248,POINT (-83.6420774300216 9.277763980985966),-83.6420774300216,9.277763980985966
1833,40,65,136,241,POINT (-83.6420774300216 9.321627980985966),-83.6420774300216,9.321627980985966
1834,34,60,135,229,POINT (-83.6420774300216 9.365491980985965),-83.6420774300216,9.365491980985965
1835,26,45,137,208,POINT (-83.6420774300216 9.409355980985964),-83.6420774300216,9.409355980985964
1836,16,36,135,187,POINT (-83.6420774300216 9.453219980985963),-83.6420774300216,9.453219980985963
1837,12,29,129,170,POINT (-83.6420774300216 9.497083980985963),-83.6420774300216,9.497083980985963
1838,10,21,124,155,POINT (-83.6420774300216 9.540947980985962),-83.6420774300216,9.540947980985962
1839,11,18,123,152,POINT (-83.6420774300216 9.584811980985961),-83.6420774300216,9.584811980985961
1840,11,22,124,157,POINT (-83.6420774300216 9.62867598098596),-83.6420774300216,9.62867598098596
1841,17,28,126,171,POINT (-83.6420774300216 9.67253998098596),-83.6420774300216,9.67253998098596
1842,23,31,126,180,POINT (-83.6420774300216 9.716403980985959),-83.6420774300216,9.716403980985959
1843,45,33,122,200,POINT (-83.6420774300216 9.760267980985958),-83.6420774300216,9.760267980985958
1844,53,43,123,219,POINT (-83.6420774300216 9.804131980985957),-83.6420774300216,9.804131980985957
1845,58,49,126,233,POINT (-83.6420774300216 9.847995980985957),-83.6420774300216,9.847995980985957
1846,59,57,126,242,POINT (-83.6420774300216 9.891859980985956),-83.6420774300216,9.891859980985956
1847,60,67,126,253,POINT (-83.6420774300216 9.935723980985955),-83.6420774300216,9.935723980985955
1848,60,71,134,265,POINT (-83.6420774300216 9.979587980985954),-83.6420774300216,9.979587980985954
1849,56,73,136,265,POINT (-83.6420774300216 10.023451980985953),-83.6420774300216,10.023451980985953
1850,65,79,141,285,POINT (-83.6420774300216 10.067315980985953),-83.6420774300216,10.067315980985953
1851,64,87,142,293,POINT (-83.6420774300216 10.111179980985952),-83.6420774300216,10.111179980985952
1852,61,89,139,289,POINT (-83.6420774300216 10.155043980985951),-83.6420774300216,10.155043980985951
1853,58,89,138,285,POINT (-83.6420774300216 10.19890798098595),-83.6420774300216,10.19890798098595
1854,56,87,137,280,POINT (-83.6420774300216 10.24277198098595),-83.6420774300216,10.24277198098595
1855,53,87,137,277,POINT (-83.6420774300216 10.286635980985949),-83.6420774300216,10.286635980985949
1856,51,88,137,276,POINT (-83.6420774300216 10.330499980985948),-83.6420774300216,10.330499980985948
1857,48,85,135,268,POINT (-83.6420774300216 10.374363980985947),-83.6420774300216,10.374363980985947
1858,48,85,134,267,POINT (-83.6420774300216 10.418227980985947),-83.6420774300216,10.418227980985947
1859,45,82,130,257,POINT (-83.6420774300216 10.462091980985946),-83.6420774300216,10.462091980985946
1860,43,81,129,253,POINT (-83.6420774300216 10.505955980985945),-83.6420774300216,10.505955980985945
1861,44,81,128,253,POINT (-83.6420774300216 10.549819980985944),-83.6420774300216,10.549819980985944
1862,43,79,128,250,POINT (-83.6420774300216 10.593683980985944),-83.6420774300216,10.593683980985944
1863,38,78,125,241,POINT (-83.6420774300216 10.637547980985943),-83.6420774300216,10.637547980985943
1864,37,77,124,238,POINT (-83.6420774300216 10.681411980985942),-83.6420774300216,10.681411980985942
1865,36,77,123,236,POINT (-83.6420774300216 10.725275980985941),-83.6420774300216,10.725275980985941
1866,36,75,123,234,POINT (-83.6420774300216 10.76913998098594),-83.6420774300216,10.76913998098594
1867,33,75,120,228,POINT (-83.6420774300216 10.81300398098594),-83.6420774300216,10.81300398098594
1868,33,76,117,226,POINT (-83.6420774300216 10.856867980985939),-83.6420774300216,10.856867980985939
1869,31,72,118,221,POINT (-83.6420774300216 10.900731980985938),-83.6420774300216,10.900731980985938
1870,48,74,124,246,POINT (-83.6061454300216 8.575939980985979),-83.6061454300216,8.575939980985979
1871,48,74,123,245,POINT (-83.6061454300216 8.619803980985978),-83.6061454300216,8.619803980985978
1872,48,74,123,245,POINT (-83.6061454300216 8.663667980985977),-83.6061454300216,8.663667980985977
1873,49,74,123,246,POINT (-83.6061454300216 8.707531980985976),-83.6061454300216,8.707531980985976
1874,49,76,122,247,POINT (-83.6061454300216 8.751395980985976),-83.6061454300216,8.751395980985976
1875,3,11,32,46,POINT (-83.6061454300216 8.795259980985975),-83.6061454300216,8.795259980985975
1876,49,16,122,187,POINT (-83.6061454300216 8.926851980985973),-83.6061454300216,8.926851980985973
1877,49,17,121,187,POINT (-83.6061454300216 8.970715980985972),-83.6061454300216,8.970715980985972
1878,49,71,122,242,POINT (-83.6061454300216 9.014579980985971),-83.6061454300216,9.014579980985971
1879,51,75,125,251,POINT (-83.6061454300216 9.05844398098597),-83.6061454300216,9.05844398098597
1880,52,75,130,257,POINT (-83.6061454300216 9.10230798098597),-83.6061454300216,9.10230798098597
1881,52,72,133,257,POINT (-83.6061454300216 9.146171980985969),-83.6061454300216,9.146171980985969
1882,52,71,137,260,POINT (-83.6061454300216 9.190035980985968),-83.6061454300216,9.190035980985968
1883,50,70,133,253,POINT (-83.6061454300216 9.233899980985967),-83.6061454300216,9.233899980985967
1884,44,66,133,243,POINT (-83.6061454300216 9.277763980985966),-83.6061454300216,9.277763980985966
1885,38,63,134,235,POINT (-83.6061454300216 9.321627980985966),-83.6061454300216,9.321627980985966
1886,30,53,137,220,POINT (-83.6061454300216 9.365491980985965),-83.6061454300216,9.365491980985965
1887,18,37,135,190,POINT (-83.6061454300216 9.409355980985964),-83.6061454300216,9.409355980985964
1888,14,34,128,176,POINT (-83.6061454300216 9.453219980985963),-83.6061454300216,9.453219980985963
1889,12,26,125,163,POINT (-83.6061454300216 9.497083980985963),-83.6061454300216,9.497083980985963
1890,11,21,124,156,POINT (-83.6061454300216 9.540947980985962),-83.6061454300216,9.540947980985962
1891,9,20,126,155,POINT (-83.6061454300216 9.584811980985961),-83.6061454300216,9.584811980985961
1892,10,22,126,158,POINT (-83.6061454300216 9.62867598098596),-83.6061454300216,9.62867598098596
1893,15,31,125,171,POINT (-83.6061454300216 9.67253998098596),-83.6061454300216,9.67253998098596
1894,21,34,124,179,POINT (-83.6061454300216 9.716403980985959),-83.6061454300216,9.716403980985959
1895,38,34,127,199,POINT (-83.6061454300216 9.760267980985958),-83.6061454300216,9.760267980985958
1896,50,44,129,223,POINT (-83.6061454300216 9.804131980985957),-83.6061454300216,9.804131980985957
1897,57,52,127,236,POINT (-83.6061454300216 9.847995980985957),-83.6061454300216,9.847995980985957
1898,63,60,126,249,POINT (-83.6061454300216 9.891859980985956),-83.6061454300216,9.891859980985956
1899,61,70,132,263,POINT (-83.6061454300216 9.935723980985955),-83.6061454300216,9.935723980985955
1900,59,78,135,272,POINT (-83.6061454300216 9.979587980985954),-83.6061454300216,9.979587980985954
1901,65,81,137,283,POINT (-83.6061454300216 10.023451980985953),-83.6061454300216,10.023451980985953
1902,70,86,140,296,POINT (-83.6061454300216 10.067315980985953),-83.6061454300216,10.067315980985953
1903,62,90,138,290,POINT (-83.6061454300216 10.111179980985952),-83.6061454300216,10.111179980985952
1904,61,89,136,286,POINT (-83.6061454300216 10.155043980985951),-83.6061454300216,10.155043980985951
1905,57,91,138,286,POINT (-83.6061454300216 10.19890798098595),-83.6061454300216,10.19890798098595
1906,53,88,136,277,POINT (-83.6061454300216 10.24277198098595),-83.6061454300216,10.24277198098595
1907,54,88,136,278,POINT (-83.6061454300216 10.286635980985949),-83.6061454300216,10.286635980985949
1908,50,88,136,274,POINT (-83.6061454300216 10.330499980985948),-83.6061454300216,10.330499980985948
1909,47,85,134,266,POINT (-83.6061454300216 10.374363980985947),-83.6061454300216,10.374363980985947
1910,47,85,130,262,POINT (-83.6061454300216 10.418227980985947),-83.6061454300216,10.418227980985947
1911,44,84,129,257,POINT (-83.6061454300216 10.462091980985946),-83.6061454300216,10.462091980985946
1912,43,80,129,252,POINT (-83.6061454300216 10.505955980985945),-83.6061454300216,10.505955980985945
1913,43,79,128,250,POINT (-83.6061454300216 10.549819980985944),-83.6061454300216,10.549819980985944
1914,43,78,127,248,POINT (-83.6061454300216 10.593683980985944),-83.6061454300216,10.593683980985944
1915,40,78,124,242,POINT (-83.6061454300216 10.637547980985943),-83.6061454300216,10.637547980985943
1916,36,77,124,237,POINT (-83.6061454300216 10.681411980985942),-83.6061454300216,10.681411980985942
1917,35,77,123,235,POINT (-83.6061454300216 10.725275980985941),-83.6061454300216,10.725275980985941
1918,34,76,123,233,POINT (-83.6061454300216 10.76913998098594),-83.6061454300216,10.76913998098594
1919,34,73,119,226,POINT (-83.6061454300216 10.81300398098594),-83.6061454300216,10.81300398098594
1920,48,74,122,244,POINT (-83.5702134300216 8.53207598098598),-83.5702134300216,8.53207598098598
1921,48,74,123,245,POINT (-83.5702134300216 8.575939980985979),-83.5702134300216,8.575939980985979
1922,48,74,123,245,POINT (-83.5702134300216 8.619803980985978),-83.5702134300216,8.619803980985978
1923,48,74,123,245,POINT (-83.5702134300216 8.663667980985977),-83.5702134300216,8.663667980985977
1924,49,74,123,246,POINT (-83.5702134300216 8.707531980985976),-83.5702134300216,8.707531980985976
1925,49,75,122,246,POINT (-83.5702134300216 8.751395980985976),-83.5702134300216,8.751395980985976
1926,49,74,121,244,POINT (-83.5702134300216 8.795259980985975),-83.5702134300216,8.795259980985975
1927,48,75,121,244,POINT (-83.5702134300216 8.839123980985974),-83.5702134300216,8.839123980985974
1928,1,12,32,45,POINT (-83.5702134300216 8.882987980985973),-83.5702134300216,8.882987980985973
1929,50,75,124,249,POINT (-83.5702134300216 8.926851980985973),-83.5702134300216,8.926851980985973
1930,50,73,123,246,POINT (-83.5702134300216 8.970715980985972),-83.5702134300216,8.970715980985972
1931,50,75,125,250,POINT (-83.5702134300216 9.014579980985971),-83.5702134300216,9.014579980985971
1932,52,76,127,255,POINT (-83.5702134300216 9.05844398098597),-83.5702134300216,9.05844398098597
1933,52,74,131,257,POINT (-83.5702134300216 9.10230798098597),-83.5702134300216,9.10230798098597
1934,51,72,135,258,POINT (-83.5702134300216 9.146171980985969),-83.5702134300216,9.146171980985969
1935,53,73,133,259,POINT (-83.5702134300216 9.190035980985968),-83.5702134300216,9.190035980985968
1936,48,69,133,250,POINT (-83.5702134300216 9.233899980985967),-83.5702134300216,9.233899980985967
1937,41,65,135,241,POINT (-83.5702134300216 9.277763980985966),-83.5702134300216,9.277763980985966
1938,32,60,134,226,POINT (-83.5702134300216 9.321627980985966),-83.5702134300216,9.321627980985966
1939,23,42,135,200,POINT (-83.5702134300216 9.365491980985965),-83.5702134300216,9.365491980985965
1940,15,35,127,177,POINT (-83.5702134300216 9.409355980985964),-83.5702134300216,9.409355980985964
1941,12,29,126,167,POINT (-83.5702134300216 9.453219980985963),-83.5702134300216,9.453219980985963
1942,8,24,125,157,POINT (-83.5702134300216 9.497083980985963),-83.5702134300216,9.497083980985963
1943,7,19,125,151,POINT (-83.5702134300216 9.540947980985962),-83.5702134300216,9.540947980985962
1944,7,21,125,153,POINT (-83.5702134300216 9.584811980985961),-83.5702134300216,9.584811980985961
1945,9,25,123,157,POINT (-83.5702134300216 9.62867598098596),-83.5702134300216,9.62867598098596
1946,14,32,123,169,POINT (-83.5702134300216 9.67253998098596),-83.5702134300216,9.67253998098596
1947,21,34,125,180,POINT (-83.5702134300216 9.716403980985959),-83.5702134300216,9.716403980985959
1948,36,39,129,204,POINT (-83.5702134300216 9.760267980985958),-83.5702134300216,9.760267980985958
1949,49,51,126,226,POINT (-83.5702134300216 9.804131980985957),-83.5702134300216,9.804131980985957
1950,57,55,125,237,POINT (-83.5702134300216 9.847995980985957),-83.5702134300216,9.847995980985957
1951,62,65,133,260,POINT (-83.5702134300216 9.891859980985956),-83.5702134300216,9.891859980985956
1952,62,77,135,274,POINT (-83.5702134300216 9.935723980985955),-83.5702134300216,9.935723980985955
1953,60,83,135,278,POINT (-83.5702134300216 9.979587980985954),-83.5702134300216,9.979587980985954
1954,70,84,139,293,POINT (-83.5702134300216 10.023451980985953),-83.5702134300216,10.023451980985953
1955,73,90,139,302,POINT (-83.5702134300216 10.067315980985953),-83.5702134300216,10.067315980985953
1956,63,89,139,291,POINT (-83.5702134300216 10.111179980985952),-83.5702134300216,10.111179980985952
1957,59,89,138,286,POINT (-83.5702134300216 10.155043980985951),-83.5702134300216,10.155043980985951
1958,58,89,136,283,POINT (-83.5702134300216 10.19890798098595),-83.5702134300216,10.19890798098595
1959,56,87,136,279,POINT (-83.5702134300216 10.24277198098595),-83.5702134300216,10.24277198098595
1960,51,87,136,274,POINT (-83.5702134300216 10.286635980985949),-83.5702134300216,10.286635980985949
1961,47,86,133,266,POINT (-83.5702134300216 10.330499980985948),-83.5702134300216,10.330499980985948
1962,47,85,131,263,POINT (-83.5702134300216 10.374363980985947),-83.5702134300216,10.374363980985947
1963,45,84,129,258,POINT (-83.5702134300216 10.418227980985947),-83.5702134300216,10.418227980985947
1964,43,81,128,252,POINT (-83.5702134300216 10.462091980985946),-83.5702134300216,10.462091980985946
1965,43,79,127,249,POINT (-83.5702134300216 10.505955980985945),-83.5702134300216,10.505955980985945
1966,43,78,126,247,POINT (-83.5702134300216 10.549819980985944),-83.5702134300216,10.549819980985944
1967,42,78,124,244,POINT (-83.5702134300216 10.593683980985944),-83.5702134300216,10.593683980985944
1968,39,77,123,239,POINT (-83.5702134300216 10.637547980985943),-83.5702134300216,10.637547980985943
1969,36,75,124,235,POINT (-83.5702134300216 10.681411980985942),-83.5702134300216,10.681411980985942
1970,0,7,29,36,POINT (-83.5702134300216 10.725275980985941),-83.5702134300216,10.725275980985941
1971,48,76,122,246,POINT (-83.5342814300216 8.48821198098598),-83.5342814300216,8.48821198098598
1972,48,74,123,245,POINT (-83.5342814300216 8.53207598098598),-83.5342814300216,8.53207598098598
1973,48,74,123,245,POINT (-83.5342814300216 8.575939980985979),-83.5342814300216,8.575939980985979
1974,48,75,123,246,POINT (-83.5342814300216 8.619803980985978),-83.5342814300216,8.619803980985978
1975,48,75,123,246,POINT (-83.5342814300216 8.663667980985977),-83.5342814300216,8.663667980985977
1976,49,75,123,247,POINT (-83.5342814300216 8.707531980985976),-83.5342814300216,8.707531980985976
1977,50,75,122,247,POINT (-83.5342814300216 8.751395980985976),-83.5342814300216,8.751395980985976
1978,49,77,122,248,POINT (-83.5342814300216 8.795259980985975),-83.5342814300216,8.795259980985975
1979,4,13,33,50,POINT (-83.5342814300216 8.839123980985974),-83.5342814300216,8.839123980985974
1980,50,77,123,250,POINT (-83.5342814300216 8.882987980985973),-83.5342814300216,8.882987980985973
1981,50,76,124,250,POINT (-83.5342814300216 8.926851980985973),-83.5342814300216,8.926851980985973
1982,50,76,124,250,POINT (-83.5342814300216 8.970715980985972),-83.5342814300216,8.970715980985972
1983,52,74,127,253,POINT (-83.5342814300216 9.014579980985971),-83.5342814300216,9.014579980985971
1984,53,75,131,259,POINT (-83.5342814300216 9.05844398098597),-83.5342814300216,9.05844398098597
1985,51,75,134,260,POINT (-83.5342814300216 9.10230798098597),-83.5342814300216,9.10230798098597
1986,53,72,135,260,POINT (-83.5342814300216 9.146171980985969),-83.5342814300216,9.146171980985969
1987,49,72,131,252,POINT (-83.5342814300216 9.190035980985968),-83.5342814300216,9.190035980985968
1988,42,66,132,240,POINT (-83.5342814300216 9.233899980985967),-83.5342814300216,9.233899980985967
1989,34,64,134,232,POINT (-83.5342814300216 9.277763980985966),-83.5342814300216,9.277763980985966
1990,29,50,136,215,POINT (-83.5342814300216 9.321627980985966),-83.5342814300216,9.321627980985966
1991,17,34,128,179,POINT (-83.5342814300216 9.365491980985965),-83.5342814300216,9.365491980985965
1992,10,27,125,162,POINT (-83.5342814300216 9.409355980985964),-83.5342814300216,9.409355980985964
1993,9,24,124,157,POINT (-83.5342814300216 9.453219980985963),-83.5342814300216,9.453219980985963
1994,8,20,122,150,POINT (-83.5342814300216 9.497083980985963),-83.5342814300216,9.497083980985963
1995,7,19,122,148,POINT (-83.5342814300216 9.540947980985962),-83.5342814300216,9.540947980985962
1996,11,25,126,162,POINT (-83.5342814300216 9.584811980985961),-83.5342814300216,9.584811980985961
1997,10,26,122,158,POINT (-83.5342814300216 9.62867598098596),-83.5342814300216,9.62867598098596
1998,14,32,123,169,POINT (-83.5342814300216 9.67253998098596),-83.5342814300216,9.67253998098596
1999,20,37,126,183,POINT (-83.5342814300216 9.716403980985959),-83.5342814300216,9.716403980985959
2000,32,49,129,210,POINT (-83.5342814300216 9.760267980985958),-83.5342814300216,9.760267980985958
2001,48,54,127,229,POINT (-83.5342814300216 9.804131980985957),-83.5342814300216,9.804131980985957
2002,56,59,131,246,POINT (-83.5342814300216 9.847995980985957),-83.5342814300216,9.847995980985957
2003,61,71,135,267,POINT (-83.5342814300216 9.891859980985956),-83.5342814300216,9.891859980985956
2004,58,78,135,271,POINT (-83.5342814300216 9.935723980985955),-83.5342814300216,9.935723980985955
2005,63,84,136,283,POINT (-83.5342814300216 9.979587980985954),-83.5342814300216,9.979587980985954
2006,70,84,138,292,POINT (-83.5342814300216 10.023451980985953),-83.5342814300216,10.023451980985953
2007,71,87,138,296,POINT (-83.5342814300216 10.067315980985953),-83.5342814300216,10.067315980985953
2008,61,89,138,288,POINT (-83.5342814300216 10.111179980985952),-83.5342814300216,10.111179980985952
2009,58,88,136,282,POINT (-83.5342814300216 10.155043980985951),-83.5342814300216,10.155043980985951
2010,58,88,136,282,POINT (-83.5342814300216 10.19890798098595),-83.5342814300216,10.19890798098595
2011,52,87,136,275,POINT (-83.5342814300216 10.24277198098595),-83.5342814300216,10.24277198098595
2012,49,87,133,269,POINT (-83.5342814300216 10.286635980985949),-83.5342814300216,10.286635980985949
2013,47,84,131,262,POINT (-83.5342814300216 10.330499980985948),-83.5342814300216,10.330499980985948
2014,46,85,130,261,POINT (-83.5342814300216 10.374363980985947),-83.5342814300216,10.374363980985947
2015,44,81,128,253,POINT (-83.5342814300216 10.418227980985947),-83.5342814300216,10.418227980985947
2016,43,81,127,251,POINT (-83.5342814300216 10.462091980985946),-83.5342814300216,10.462091980985946
2017,43,79,126,248,POINT (-83.5342814300216 10.505955980985945),-83.5342814300216,10.505955980985945
2018,43,79,126,248,POINT (-83.5342814300216 10.549819980985944),-83.5342814300216,10.549819980985944
2019,39,75,124,238,POINT (-83.5342814300216 10.593683980985944),-83.5342814300216,10.593683980985944
2020,0,4,29,33,POINT (-83.5342814300216 10.637547980985943),-83.5342814300216,10.637547980985943
2021,46,59,113,218,POINT (-83.49834943002159 8.444347980985981),-83.49834943002159,8.444347980985981
2022,48,74,122,244,POINT (-83.49834943002159 8.48821198098598),-83.49834943002159,8.48821198098598
2023,48,74,123,245,POINT (-83.49834943002159 8.53207598098598),-83.49834943002159,8.53207598098598
2024,48,74,123,245,POINT (-83.49834943002159 8.575939980985979),-83.49834943002159,8.575939980985979
2025,48,75,123,246,POINT (-83.49834943002159 8.619803980985978),-83.49834943002159,8.619803980985978
2026,48,75,123,246,POINT (-83.49834943002159 8.663667980985977),-83.49834943002159,8.663667980985977
2027,51,74,123,248,POINT (-83.49834943002159 8.707531980985976),-83.49834943002159,8.707531980985976
2028,50,78,122,250,POINT (-83.49834943002159 8.751395980985976),-83.49834943002159,8.751395980985976
2029,51,78,123,252,POINT (-83.49834943002159 8.795259980985975),-83.49834943002159,8.795259980985975
2030,49,77,123,249,POINT (-83.49834943002159 8.839123980985974),-83.49834943002159,8.839123980985974
2031,50,77,123,250,POINT (-83.49834943002159 8.882987980985973),-83.49834943002159,8.882987980985973
2032,50,77,125,252,POINT (-83.49834943002159 8.926851980985973),-83.49834943002159,8.926851980985973
2033,51,76,126,253,POINT (-83.49834943002159 8.970715980985972),-83.49834943002159,8.970715980985972
2034,52,77,131,260,POINT (-83.49834943002159 9.014579980985971),-83.49834943002159,9.014579980985971
2035,52,77,135,264,POINT (-83.49834943002159 9.05844398098597),-83.49834943002159,9.05844398098597
2036,52,73,136,261,POINT (-83.49834943002159 9.10230798098597),-83.49834943002159,9.10230798098597
2037,51,70,132,253,POINT (-83.49834943002159 9.146171980985969),-83.49834943002159,9.146171980985969
2038,44,68,131,243,POINT (-83.49834943002159 9.190035980985968),-83.49834943002159,9.190035980985968
2039,39,64,133,236,POINT (-83.49834943002159 9.233899980985967),-83.49834943002159,9.233899980985967
2040,30,60,130,220,POINT (-83.49834943002159 9.277763980985966),-83.49834943002159,9.277763980985966
2041,21,45,126,192,POINT (-83.49834943002159 9.321627980985966),-83.49834943002159,9.321627980985966
2042,14,37,125,176,POINT (-83.49834943002159 9.365491980985965),-83.49834943002159,9.365491980985965
2043,9,23,123,155,POINT (-83.49834943002159 9.409355980985964),-83.49834943002159,9.409355980985964
2044,8,19,122,149,POINT (-83.49834943002159 9.453219980985963),-83.49834943002159,9.453219980985963
2045,7,19,122,148,POINT (-83.49834943002159 9.497083980985963),-83.49834943002159,9.497083980985963
2046,9,20,122,151,POINT (-83.49834943002159 9.540947980985962),-83.49834943002159,9.540947980985962
2047,11,27,123,161,POINT (-83.49834943002159 9.584811980985961),-83.49834943002159,9.584811980985961
2048,13,31,124,168,POINT (-83.49834943002159 9.62867598098596),-83.49834943002159,9.62867598098596
2049,15,29,125,169,POINT (-83.49834943002159 9.67253998098596),-83.49834943002159,9.67253998098596
2050,20,41,128,189,POINT (-83.49834943002159 9.716403980985959),-83.49834943002159,9.716403980985959
2051,32,48,127,207,POINT (-83.49834943002159 9.760267980985958),-83.49834943002159,9.760267980985958
2052,46,55,131,232,POINT (-83.49834943002159 9.804131980985957),-83.49834943002159,9.804131980985957
2053,56,59,134,249,POINT (-83.49834943002159 9.847995980985957),-83.49834943002159,9.847995980985957
2054,59,71,135,265,POINT (-83.49834943002159 9.891859980985956),-83.49834943002159,9.891859980985956
2055,57,80,137,274,POINT (-83.49834943002159 9.935723980985955),-83.49834943002159,9.935723980985955
2056,66,84,137,287,POINT (-83.49834943002159 9.979587980985954),-83.49834943002159,9.979587980985954
2057,69,86,138,293,POINT (-83.49834943002159 10.023451980985953),-83.49834943002159,10.023451980985953
2058,66,88,138,292,POINT (-83.49834943002159 10.067315980985953),-83.49834943002159,10.067315980985953
2059,59,89,138,286,POINT (-83.49834943002159 10.111179980985952),-83.49834943002159,10.111179980985952
2060,57,89,136,282,POINT (-83.49834943002159 10.155043980985951),-83.49834943002159,10.155043980985951
2061,54,88,136,278,POINT (-83.49834943002159 10.19890798098595),-83.49834943002159,10.19890798098595
2062,51,87,133,271,POINT (-83.49834943002159 10.24277198098595),-83.49834943002159,10.24277198098595
2063,46,85,130,261,POINT (-83.49834943002159 10.286635980985949),-83.49834943002159,10.286635980985949
2064,46,84,128,258,POINT (-83.49834943002159 10.330499980985948),-83.49834943002159,10.330499980985948
2065,45,79,127,251,POINT (-83.49834943002159 10.374363980985947),-83.49834943002159,10.374363980985947
2066,44,80,127,251,POINT (-83.49834943002159 10.418227980985947),-83.49834943002159,10.418227980985947
2067,42,81,127,250,POINT (-83.49834943002159 10.462091980985946),-83.49834943002159,10.462091980985946
2068,42,77,126,245,POINT (-83.49834943002159 10.505955980985945),-83.49834943002159,10.505955980985945
2069,0,4,29,33,POINT (-83.49834943002159 10.549819980985944),-83.49834943002159,10.549819980985944
2070,0,3,29,32,POINT (-83.49834943002159 10.593683980985944),-83.49834943002159,10.593683980985944
2071,46,61,121,228,POINT (-83.46241743002159 8.444347980985981),-83.46241743002159,8.444347980985981
2072,47,74,123,244,POINT (-83.46241743002159 8.48821198098598),-83.46241743002159,8.48821198098598
2073,48,74,123,245,POINT (-83.46241743002159 8.53207598098598),-83.46241743002159,8.53207598098598
2074,48,74,123,245,POINT (-83.46241743002159 8.575939980985979),-83.46241743002159,8.575939980985979
2075,48,75,123,246,POINT (-83.46241743002159 8.619803980985978),-83.46241743002159,8.619803980985978
2076,47,38,122,207,POINT (-83.46241743002159 8.663667980985977),-83.46241743002159,8.663667980985977
2077,0,9,26,35,POINT (-83.46241743002159 8.707531980985976),-83.46241743002159,8.707531980985976
2078,50,78,123,251,POINT (-83.46241743002159 8.751395980985976),-83.46241743002159,8.751395980985976
2079,51,78,123,252,POINT (-83.46241743002159 8.795259980985975),-83.46241743002159,8.795259980985975
2080,51,79,124,254,POINT (-83.46241743002159 8.839123980985974),-83.46241743002159,8.839123980985974
2081,50,77,127,254,POINT (-83.46241743002159 8.882987980985973),-83.46241743002159,8.882987980985973
2082,51,76,127,254,POINT (-83.46241743002159 8.926851980985973),-83.46241743002159,8.926851980985973
2083,52,76,128,256,POINT (-83.46241743002159 8.970715980985972),-83.46241743002159,8.970715980985972
2084,53,76,132,261,POINT (-83.46241743002159 9.014579980985971),-83.46241743002159,9.014579980985971
2085,51,75,135,261,POINT (-83.46241743002159 9.05844398098597),-83.46241743002159,9.05844398098597
2086,51,70,132,253,POINT (-83.46241743002159 9.10230798098597),-83.46241743002159,9.10230798098597
2087,48,70,132,250,POINT (-83.46241743002159 9.146171980985969),-83.46241743002159,9.146171980985969
2088,42,64,130,236,POINT (-83.46241743002159 9.190035980985968),-83.46241743002159,9.190035980985968
2089,34,66,130,230,POINT (-83.46241743002159 9.233899980985967),-83.46241743002159,9.233899980985967
2090,25,52,128,205,POINT (-83.46241743002159 9.277763980985966),-83.46241743002159,9.277763980985966
2091,18,42,124,184,POINT (-83.46241743002159 9.321627980985966),-83.46241743002159,9.321627980985966
2092,10,26,125,161,POINT (-83.46241743002159 9.365491980985965),-83.46241743002159,9.365491980985965
2093,9,21,120,150,POINT (-83.46241743002159 9.409355980985964),-83.46241743002159,9.409355980985964
2094,8,19,121,148,POINT (-83.46241743002159 9.453219980985963),-83.46241743002159,9.453219980985963
2095,7,19,122,148,POINT (-83.46241743002159 9.497083980985963),-83.46241743002159,9.497083980985963
2096,8,18,122,148,POINT (-83.46241743002159 9.540947980985962),-83.46241743002159,9.540947980985962
2097,9,25,124,158,POINT (-83.46241743002159 9.584811980985961),-83.46241743002159,9.584811980985961
2098,14,33,124,171,POINT (-83.46241743002159 9.62867598098596),-83.46241743002159,9.62867598098596
2099,19,33,128,180,POINT (-83.46241743002159 9.67253998098596),-83.46241743002159,9.67253998098596
2100,24,46,129,199,POINT (-83.46241743002159 9.716403980985959),-83.46241743002159,9.716403980985959
2101,30,49,134,213,POINT (-83.46241743002159 9.760267980985958),-83.46241743002159,9.760267980985958
2102,45,54,135,234,POINT (-83.46241743002159 9.804131980985957),-83.46241743002159,9.804131980985957
2103,55,63,133,251,POINT (-83.46241743002159 9.847995980985957),-83.46241743002159,9.847995980985957
2104,56,74,138,268,POINT (-83.46241743002159 9.891859980985956),-83.46241743002159,9.891859980985956
2105,62,82,137,281,POINT (-83.46241743002159 9.935723980985955),-83.46241743002159,9.935723980985955
2106,67,84,139,290,POINT (-83.46241743002159 9.979587980985954),-83.46241743002159,9.979587980985954
2107,71,86,138,295,POINT (-83.46241743002159 10.023451980985953),-83.46241743002159,10.023451980985953
2108,65,88,136,289,POINT (-83.46241743002159 10.067315980985953),-83.46241743002159,10.067315980985953
2109,58,88,137,283,POINT (-83.46241743002159 10.111179980985952),-83.46241743002159,10.111179980985952
2110,55,89,136,280,POINT (-83.46241743002159 10.155043980985951),-83.46241743002159,10.155043980985951
2111,51,87,132,270,POINT (-83.46241743002159 10.19890798098595),-83.46241743002159,10.19890798098595
2112,47,86,129,262,POINT (-83.46241743002159 10.24277198098595),-83.46241743002159,10.24277198098595
2113,46,85,127,258,POINT (-83.46241743002159 10.286635980985949),-83.46241743002159,10.286635980985949
2114,46,80,127,253,POINT (-83.46241743002159 10.330499980985948),-83.46241743002159,10.330499980985948
2115,44,78,127,249,POINT (-83.46241743002159 10.374363980985947),-83.46241743002159,10.374363980985947
2116,43,78,127,248,POINT (-83.46241743002159 10.418227980985947),-83.46241743002159,10.418227980985947
2117,0,10,40,50,POINT (-83.46241743002159 10.462091980985946),-83.46241743002159,10.462091980985946
2118,0,3,29,32,POINT (-83.46241743002159 10.505955980985945),-83.46241743002159,10.505955980985945
2119,46,74,120,240,POINT (-83.42648543002159 8.444347980985981),-83.42648543002159,8.444347980985981
2120,47,74,123,244,POINT (-83.42648543002159 8.48821198098598),-83.42648543002159,8.48821198098598
2121,47,74,123,244,POINT (-83.42648543002159 8.53207598098598),-83.42648543002159,8.53207598098598
2122,47,74,123,244,POINT (-83.42648543002159 8.575939980985979),-83.42648543002159,8.575939980985979
2123,0,9,26,35,POINT (-83.42648543002159 8.619803980985978),-83.42648543002159,8.619803980985978
2124,0,8,26,34,POINT (-83.42648543002159 8.663667980985977),-83.42648543002159,8.663667980985977
2125,0,6,26,32,POINT (-83.42648543002159 8.707531980985976),-83.42648543002159,8.707531980985976
2126,50,78,124,252,POINT (-83.42648543002159 8.751395980985976),-83.42648543002159,8.751395980985976
2127,51,78,125,254,POINT (-83.42648543002159 8.795259980985975),-83.42648543002159,8.795259980985975
2128,50,77,127,254,POINT (-83.42648543002159 8.839123980985974),-83.42648543002159,8.839123980985974
2129,50,76,127,253,POINT (-83.42648543002159 8.882987980985973),-83.42648543002159,8.882987980985973
2130,50,78,127,255,POINT (-83.42648543002159 8.926851980985973),-83.42648543002159,8.926851980985973
2131,50,76,130,256,POINT (-83.42648543002159 8.970715980985972),-83.42648543002159,8.970715980985972
2132,50,76,135,261,POINT (-83.42648543002159 9.014579980985971),-83.42648543002159,9.014579980985971
2133,49,71,133,253,POINT (-83.42648543002159 9.05844398098597),-83.42648543002159,9.05844398098597
2134,48,71,133,252,POINT (-83.42648543002159 9.10230798098597),-83.42648543002159,9.10230798098597
2135,42,66,131,239,POINT (-83.42648543002159 9.146171980985969),-83.42648543002159,9.146171980985969
2136,38,64,129,231,POINT (-83.42648543002159 9.190035980985968),-83.42648543002159,9.190035980985968
2137,30,59,125,214,POINT (-83.42648543002159 9.233899980985967),-83.42648543002159,9.233899980985967
2138,22,47,118,187,POINT (-83.42648543002159 9.277763980985966),-83.42648543002159,9.277763980985966
2139,12,30,122,164,POINT (-83.42648543002159 9.321627980985966),-83.42648543002159,9.321627980985966
2140,9,22,121,152,POINT (-83.42648543002159 9.365491980985965),-83.42648543002159,9.365491980985965
2141,7,19,117,143,POINT (-83.42648543002159 9.409355980985964),-83.42648543002159,9.409355980985964
2142,6,18,120,144,POINT (-83.42648543002159 9.453219980985963),-83.42648543002159,9.453219980985963
2143,7,21,121,149,POINT (-83.42648543002159 9.497083980985963),-83.42648543002159,9.497083980985963
2144,8,25,120,153,POINT (-83.42648543002159 9.540947980985962),-83.42648543002159,9.540947980985962
2145,11,27,123,161,POINT (-83.42648543002159 9.584811980985961),-83.42648543002159,9.584811980985961
2146,14,33,126,173,POINT (-83.42648543002159 9.62867598098596),-83.42648543002159,9.62867598098596
2147,18,43,129,190,POINT (-83.42648543002159 9.67253998098596),-83.42648543002159,9.67253998098596
2148,25,45,131,201,POINT (-83.42648543002159 9.716403980985959),-83.42648543002159,9.716403980985959
2149,30,51,136,217,POINT (-83.42648543002159 9.760267980985958),-83.42648543002159,9.760267980985958
2150,44,55,134,233,POINT (-83.42648543002159 9.804131980985957),-83.42648543002159,9.804131980985957
2151,55,67,136,258,POINT (-83.42648543002159 9.847995980985957),-83.42648543002159,9.847995980985957
2152,60,73,138,271,POINT (-83.42648543002159 9.891859980985956),-83.42648543002159,9.891859980985956
2153,65,84,139,288,POINT (-83.42648543002159 9.935723980985955),-83.42648543002159,9.935723980985955
2154,72,85,139,296,POINT (-83.42648543002159 9.979587980985954),-83.42648543002159,9.979587980985954
2155,65,89,136,290,POINT (-83.42648543002159 10.023451980985953),-83.42648543002159,10.023451980985953
2156,62,87,135,284,POINT (-83.42648543002159 10.067315980985953),-83.42648543002159,10.067315980985953
2157,57,88,135,280,POINT (-83.42648543002159 10.111179980985952),-83.42648543002159,10.111179980985952
2158,52,88,131,271,POINT (-83.42648543002159 10.155043980985951),-83.42648543002159,10.155043980985951
2159,49,86,129,264,POINT (-83.42648543002159 10.19890798098595),-83.42648543002159,10.19890798098595
2160,47,83,128,258,POINT (-83.42648543002159 10.24277198098595),-83.42648543002159,10.24277198098595
2161,46,81,126,253,POINT (-83.42648543002159 10.286635980985949),-83.42648543002159,10.286635980985949
2162,44,79,125,248,POINT (-83.42648543002159 10.330499980985948),-83.42648543002159,10.330499980985948
2163,43,78,127,248,POINT (-83.42648543002159 10.374363980985947),-83.42648543002159,10.374363980985947
2164,0,4,29,33,POINT (-83.42648543002159 10.418227980985947),-83.42648543002159,10.418227980985947
2165,0,9,26,35,POINT (-83.39055343002158 8.400483980985982),-83.39055343002158,8.400483980985982
2166,47,73,122,242,POINT (-83.39055343002158 8.444347980985981),-83.39055343002158,8.444347980985981
2167,47,73,122,242,POINT (-83.39055343002158 8.48821198098598),-83.39055343002158,8.48821198098598
2168,47,74,123,244,POINT (-83.39055343002158 8.53207598098598),-83.39055343002158,8.53207598098598
2169,46,74,123,243,POINT (-83.39055343002158 8.575939980985979),-83.39055343002158,8.575939980985979
2170,0,8,26,34,POINT (-83.39055343002158 8.619803980985978),-83.39055343002158,8.619803980985978
2171,0,6,26,32,POINT (-83.39055343002158 8.663667980985977),-83.39055343002158,8.663667980985977
2172,0,6,26,32,POINT (-83.39055343002158 8.707531980985976),-83.39055343002158,8.707531980985976
2173,49,77,126,252,POINT (-83.39055343002158 8.751395980985976),-83.39055343002158,8.751395980985976
2174,50,77,126,253,POINT (-83.39055343002158 8.795259980985975),-83.39055343002158,8.795259980985975
2175,51,75,126,252,POINT (-83.39055343002158 8.839123980985974),-83.39055343002158,8.839123980985974
2176,50,76,126,252,POINT (-83.39055343002158 8.882987980985973),-83.39055343002158,8.882987980985973
2177,49,78,127,254,POINT (-83.39055343002158 8.926851980985973),-83.39055343002158,8.926851980985973
2178,49,78,133,260,POINT (-83.39055343002158 8.970715980985972),-83.39055343002158,8.970715980985972
2179,49,71,137,257,POINT (-83.39055343002158 9.014579980985971),-83.39055343002158,9.014579980985971
2180,49,72,132,253,POINT (-83.39055343002158 9.05844398098597),-83.39055343002158,9.05844398098597
2181,44,68,132,244,POINT (-83.39055343002158 9.10230798098597),-83.39055343002158,9.10230798098597
2182,41,66,130,237,POINT (-83.39055343002158 9.146171980985969),-83.39055343002158,9.146171980985969
2183,34,65,126,225,POINT (-83.39055343002158 9.190035980985968),-83.39055343002158,9.190035980985968
2184,26,53,118,197,POINT (-83.39055343002158 9.233899980985967),-83.39055343002158,9.233899980985967
2185,17,37,122,176,POINT (-83.39055343002158 9.277763980985966),-83.39055343002158,9.277763980985966
2186,8,25,120,153,POINT (-83.39055343002158 9.321627980985966),-83.39055343002158,9.321627980985966
2187,9,20,120,149,POINT (-83.39055343002158 9.365491980985965),-83.39055343002158,9.365491980985965
2188,7,19,119,145,POINT (-83.39055343002158 9.409355980985964),-83.39055343002158,9.409355980985964
2189,10,16,121,147,POINT (-83.39055343002158 9.453219980985963),-83.39055343002158,9.453219980985963
2190,11,23,120,154,POINT (-83.39055343002158 9.497083980985963),-83.39055343002158,9.497083980985963
2191,11,27,123,161,POINT (-83.39055343002158 9.540947980985962),-83.39055343002158,9.540947980985962
2192,11,32,125,168,POINT (-83.39055343002158 9.584811980985961),-83.39055343002158,9.584811980985961
2193,15,36,125,176,POINT (-83.39055343002158 9.62867598098596),-83.39055343002158,9.62867598098596
2194,18,44,130,192,POINT (-83.39055343002158 9.67253998098596),-83.39055343002158,9.67253998098596
2195,28,50,135,213,POINT (-83.39055343002158 9.716403980985959),-83.39055343002158,9.716403980985959
2196,35,54,130,219,POINT (-83.39055343002158 9.760267980985958),-83.39055343002158,9.760267980985958
2197,41,60,135,236,POINT (-83.39055343002158 9.804131980985957),-83.39055343002158,9.804131980985957
2198,51,66,137,254,POINT (-83.39055343002158 9.847995980985957),-83.39055343002158,9.847995980985957
2199,62,79,137,278,POINT (-83.39055343002158 9.891859980985956),-83.39055343002158,9.891859980985956
2200,68,82,137,287,POINT (-83.39055343002158 9.935723980985955),-83.39055343002158,9.935723980985955
2201,70,87,135,292,POINT (-83.39055343002158 9.979587980985954),-83.39055343002158,9.979587980985954
2202,66,88,134,288,POINT (-83.39055343002158 10.023451980985953),-83.39055343002158,10.023451980985953
2203,59,88,133,280,POINT (-83.39055343002158 10.067315980985953),-83.39055343002158,10.067315980985953
2204,54,88,132,274,POINT (-83.39055343002158 10.111179980985952),-83.39055343002158,10.111179980985952
2205,50,88,130,268,POINT (-83.39055343002158 10.155043980985951),-83.39055343002158,10.155043980985951
2206,47,84,128,259,POINT (-83.39055343002158 10.19890798098595),-83.39055343002158,10.19890798098595
2207,46,80,127,253,POINT (-83.39055343002158 10.24277198098595),-83.39055343002158,10.24277198098595
2208,45,80,126,251,POINT (-83.39055343002158 10.286635980985949),-83.39055343002158,10.286635980985949
2209,44,77,125,246,POINT (-83.39055343002158 10.330499980985948),-83.39055343002158,10.330499980985948
2210,0,4,29,33,POINT (-83.39055343002158 10.374363980985947),-83.39055343002158,10.374363980985947
2211,46,72,112,230,POINT (-83.35462143002158 8.400483980985982),-83.35462143002158,8.400483980985982
2212,47,73,122,242,POINT (-83.35462143002158 8.444347980985981),-83.35462143002158,8.444347980985981
2213,47,75,122,244,POINT (-83.35462143002158 8.48821198098598),-83.35462143002158,8.48821198098598
2214,47,75,121,243,POINT (-83.35462143002158 8.53207598098598),-83.35462143002158,8.53207598098598
2215,0,10,32,42,POINT (-83.35462143002158 8.575939980985979),-83.35462143002158,8.575939980985979
2216,0,7,26,33,POINT (-83.35462143002158 8.619803980985978),-83.35462143002158,8.619803980985978
2217,0,6,26,32,POINT (-83.35462143002158 8.663667980985977),-83.35462143002158,8.663667980985977
2218,0,6,26,32,POINT (-83.35462143002158 8.707531980985976),-83.35462143002158,8.707531980985976
2219,49,76,125,250,POINT (-83.35462143002158 8.751395980985976),-83.35462143002158,8.751395980985976
2220,51,75,126,252,POINT (-83.35462143002158 8.795259980985975),-83.35462143002158,8.795259980985975
2221,50,75,126,251,POINT (-83.35462143002158 8.839123980985974),-83.35462143002158,8.839123980985974
2222,50,76,127,253,POINT (-83.35462143002158 8.882987980985973),-83.35462143002158,8.882987980985973
2223,48,76,128,252,POINT (-83.35462143002158 8.926851980985973),-83.35462143002158,8.926851980985973
2224,48,75,136,259,POINT (-83.35462143002158 8.970715980985972),-83.35462143002158,8.970715980985972
2225,49,69,135,253,POINT (-83.35462143002158 9.014579980985971),-83.35462143002158,9.014579980985971
2226,45,70,133,248,POINT (-83.35462143002158 9.05844398098597),-83.35462143002158,9.05844398098597
2227,42,68,132,242,POINT (-83.35462143002158 9.10230798098597),-83.35462143002158,9.10230798098597
2228,38,65,129,232,POINT (-83.35462143002158 9.146171980985969),-83.35462143002158,9.146171980985969
2229,29,58,115,202,POINT (-83.35462143002158 9.190035980985968),-83.35462143002158,9.190035980985968
2230,22,47,117,186,POINT (-83.35462143002158 9.233899980985967),-83.35462143002158,9.233899980985967
2231,17,30,122,169,POINT (-83.35462143002158 9.277763980985966),-83.35462143002158,9.277763980985966
2232,8,22,123,153,POINT (-83.35462143002158 9.321627980985966),-83.35462143002158,9.321627980985966
2233,8,19,119,146,POINT (-83.35462143002158 9.365491980985965),-83.35462143002158,9.365491980985965
2234,6,16,119,141,POINT (-83.35462143002158 9.409355980985964),-83.35462143002158,9.409355980985964
2235,10,18,121,149,POINT (-83.35462143002158 9.453219980985963),-83.35462143002158,9.453219980985963
2236,12,27,119,158,POINT (-83.35462143002158 9.497083980985963),-83.35462143002158,9.497083980985963
2237,13,30,124,167,POINT (-83.35462143002158 9.540947980985962),-83.35462143002158,9.540947980985962
2238,13,35,125,173,POINT (-83.35462143002158 9.584811980985961),-83.35462143002158,9.584811980985961
2239,16,38,131,185,POINT (-83.35462143002158 9.62867598098596),-83.35462143002158,9.62867598098596
2240,23,44,137,204,POINT (-83.35462143002158 9.67253998098596),-83.35462143002158,9.67253998098596
2241,28,52,133,213,POINT (-83.35462143002158 9.716403980985959),-83.35462143002158,9.716403980985959
2242,37,57,132,226,POINT (-83.35462143002158 9.760267980985958),-83.35462143002158,9.760267980985958
2243,44,69,134,247,POINT (-83.35462143002158 9.804131980985957),-83.35462143002158,9.804131980985957
2244,52,72,136,260,POINT (-83.35462143002158 9.847995980985957),-83.35462143002158,9.847995980985957
2245,59,79,140,278,POINT (-83.35462143002158 9.891859980985956),-83.35462143002158,9.891859980985956
2246,65,87,135,287,POINT (-83.35462143002158 9.935723980985955),-83.35462143002158,9.935723980985955
2247,64,88,133,285,POINT (-83.35462143002158 9.979587980985954),-83.35462143002158,9.979587980985954
2248,63,87,134,284,POINT (-83.35462143002158 10.023451980985953),-83.35462143002158,10.023451980985953
2249,57,87,132,276,POINT (-83.35462143002158 10.067315980985953),-83.35462143002158,10.067315980985953
2250,52,88,130,270,POINT (-83.35462143002158 10.111179980985952),-83.35462143002158,10.111179980985952
2251,49,85,127,261,POINT (-83.35462143002158 10.155043980985951),-83.35462143002158,10.155043980985951
2252,47,82,128,257,POINT (-83.35462143002158 10.19890798098595),-83.35462143002158,10.19890798098595
2253,45,81,126,252,POINT (-83.35462143002158 10.24277198098595),-83.35462143002158,10.24277198098595
2254,44,79,126,249,POINT (-83.35462143002158 10.286635980985949),-83.35462143002158,10.286635980985949
2255,0,5,29,34,POINT (-83.35462143002158 10.330499980985948),-83.35462143002158,10.330499980985948
2256,47,71,122,240,POINT (-83.31868943002158 8.400483980985982),-83.31868943002158,8.400483980985982
2257,47,76,121,244,POINT (-83.31868943002158 8.444347980985981),-83.31868943002158,8.444347980985981
2258,48,75,121,244,POINT (-83.31868943002158 8.48821198098598),-83.31868943002158,8.48821198098598
2259,47,75,121,243,POINT (-83.31868943002158 8.53207598098598),-83.31868943002158,8.53207598098598
2260,0,8,26,34,POINT (-83.31868943002158 8.575939980985979),-83.31868943002158,8.575939980985979
2261,0,6,26,32,POINT (-83.31868943002158 8.619803980985978),-83.31868943002158,8.619803980985978
2262,0,8,26,34,POINT (-83.31868943002158 8.663667980985977),-83.31868943002158,8.663667980985977
2263,49,71,122,242,POINT (-83.31868943002158 8.707531980985976),-83.31868943002158,8.707531980985976
2264,51,76,124,251,POINT (-83.31868943002158 8.751395980985976),-83.31868943002158,8.751395980985976
2265,51,75,126,252,POINT (-83.31868943002158 8.795259980985975),-83.31868943002158,8.795259980985975
2266,50,74,128,252,POINT (-83.31868943002158 8.839123980985974),-83.31868943002158,8.839123980985974
2267,49,76,128,253,POINT (-83.31868943002158 8.882987980985973),-83.31868943002158,8.882987980985973
2268,48,76,133,257,POINT (-83.31868943002158 8.926851980985973),-83.31868943002158,8.926851980985973
2269,46,72,135,253,POINT (-83.31868943002158 8.970715980985972),-83.31868943002158,8.970715980985972
2270,45,71,131,247,POINT (-83.31868943002158 9.014579980985971),-83.31868943002158,9.014579980985971
2271,42,69,132,243,POINT (-83.31868943002158 9.05844398098597),-83.31868943002158,9.05844398098597
2272,37,63,131,231,POINT (-83.31868943002158 9.10230798098597),-83.31868943002158,9.10230798098597
2273,32,59,123,214,POINT (-83.31868943002158 9.146171980985969),-83.31868943002158,9.146171980985969
2274,24,54,116,194,POINT (-83.31868943002158 9.190035980985968),-83.31868943002158,9.190035980985968
2275,19,47,116,182,POINT (-83.31868943002158 9.233899980985967),-83.31868943002158,9.233899980985967
2276,17,29,121,167,POINT (-83.31868943002158 9.277763980985966),-83.31868943002158,9.277763980985966
2277,11,22,124,157,POINT (-83.31868943002158 9.321627980985966),-83.31868943002158,9.321627980985966
2278,8,17,119,144,POINT (-83.31868943002158 9.365491980985965),-83.31868943002158,9.365491980985965
2279,7,17,121,145,POINT (-83.31868943002158 9.409355980985964),-83.31868943002158,9.409355980985964
2280,8,21,120,149,POINT (-83.31868943002158 9.453219980985963),-83.31868943002158,9.453219980985963
2281,11,28,123,162,POINT (-83.31868943002158 9.497083980985963),-83.31868943002158,9.497083980985963
2282,14,33,121,168,POINT (-83.31868943002158 9.540947980985962),-83.31868943002158,9.540947980985962
2283,16,37,124,177,POINT (-83.31868943002158 9.584811980985961),-83.31868943002158,9.584811980985961
2284,19,41,134,194,POINT (-83.31868943002158 9.62867598098596),-83.31868943002158,9.62867598098596
2285,26,40,136,202,POINT (-83.31868943002158 9.67253998098596),-83.31868943002158,9.67253998098596
2286,31,51,134,216,POINT (-83.31868943002158 9.716403980985959),-83.31868943002158,9.716403980985959
2287,39,63,135,237,POINT (-83.31868943002158 9.760267980985958),-83.31868943002158,9.760267980985958
2288,48,72,135,255,POINT (-83.31868943002158 9.804131980985957),-83.31868943002158,9.804131980985957
2289,51,77,138,266,POINT (-83.31868943002158 9.847995980985957),-83.31868943002158,9.847995980985957
2290,62,87,136,285,POINT (-83.31868943002158 9.891859980985956),-83.31868943002158,9.891859980985956
2291,65,88,134,287,POINT (-83.31868943002158 9.935723980985955),-83.31868943002158,9.935723980985955
2292,60,86,134,280,POINT (-83.31868943002158 9.979587980985954),-83.31868943002158,9.979587980985954
2293,59,86,133,278,POINT (-83.31868943002158 10.023451980985953),-83.31868943002158,10.023451980985953
2294,54,88,130,272,POINT (-83.31868943002158 10.067315980985953),-83.31868943002158,10.067315980985953
2295,52,85,127,264,POINT (-83.31868943002158 10.111179980985952),-83.31868943002158,10.111179980985952
2296,48,84,127,259,POINT (-83.31868943002158 10.155043980985951),-83.31868943002158,10.155043980985951
2297,46,83,125,254,POINT (-83.31868943002158 10.19890798098595),-83.31868943002158,10.19890798098595
2298,45,79,125,249,POINT (-83.31868943002158 10.24277198098595),-83.31868943002158,10.24277198098595
2299,0,6,29,35,POINT (-83.31868943002158 10.286635980985949),-83.31868943002158,10.286635980985949
2300,0,6,26,32,POINT (-83.28275743002158 8.356619980985982),-83.28275743002158,8.356619980985982
2301,1,10,33,44,POINT (-83.28275743002158 8.400483980985982),-83.28275743002158,8.400483980985982
2302,0,9,33,42,POINT (-83.28275743002158 8.444347980985981),-83.28275743002158,8.444347980985981
2303,0,9,26,35,POINT (-83.28275743002158 8.48821198098598),-83.28275743002158,8.48821198098598
2304,0,9,26,35,POINT (-83.28275743002158 8.53207598098598),-83.28275743002158,8.53207598098598
2305,0,6,26,32,POINT (-83.28275743002158 8.575939980985979),-83.28275743002158,8.575939980985979
2306,0,6,26,32,POINT (-83.28275743002158 8.619803980985978),-83.28275743002158,8.619803980985978
2307,48,57,123,228,POINT (-83.28275743002158 8.663667980985977),-83.28275743002158,8.663667980985977
2308,50,73,125,248,POINT (-83.28275743002158 8.707531980985976),-83.28275743002158,8.707531980985976
2309,51,75,125,251,POINT (-83.28275743002158 8.751395980985976),-83.28275743002158,8.751395980985976
2310,50,76,127,253,POINT (-83.28275743002158 8.795259980985975),-83.28275743002158,8.795259980985975
2311,49,76,128,253,POINT (-83.28275743002158 8.839123980985974),-83.28275743002158,8.839123980985974
2312,48,72,131,251,POINT (-83.28275743002158 8.882987980985973),-83.28275743002158,8.882987980985973
2313,48,73,135,256,POINT (-83.28275743002158 8.926851980985973),-83.28275743002158,8.926851980985973
2314,44,71,132,247,POINT (-83.28275743002158 8.970715980985972),-83.28275743002158,8.970715980985972
2315,41,71,133,245,POINT (-83.28275743002158 9.014579980985971),-83.28275743002158,9.014579980985971
2316,36,67,130,233,POINT (-83.28275743002158 9.05844398098597),-83.28275743002158,9.05844398098597
2317,33,64,126,223,POINT (-83.28275743002158 9.10230798098597),-83.28275743002158,9.10230798098597
2318,28,56,116,200,POINT (-83.28275743002158 9.146171980985969),-83.28275743002158,9.146171980985969
2319,22,48,117,187,POINT (-83.28275743002158 9.190035980985968),-83.28275743002158,9.190035980985968
2320,17,38,118,173,POINT (-83.28275743002158 9.233899980985967),-83.28275743002158,9.233899980985967
2321,16,26,119,161,POINT (-83.28275743002158 9.277763980985966),-83.28275743002158,9.277763980985966
2322,11,20,123,154,POINT (-83.28275743002158 9.321627980985966),-83.28275743002158,9.321627980985966
2323,8,15,119,142,POINT (-83.28275743002158 9.365491980985965),-83.28275743002158,9.365491980985965
2324,8,18,122,148,POINT (-83.28275743002158 9.409355980985964),-83.28275743002158,9.409355980985964
2325,8,23,122,153,POINT (-83.28275743002158 9.453219980985963),-83.28275743002158,9.453219980985963
2326,10,30,124,164,POINT (-83.28275743002158 9.497083980985963),-83.28275743002158,9.497083980985963
2327,13,37,121,171,POINT (-83.28275743002158 9.540947980985962),-83.28275743002158,9.540947980985962
2328,19,41,128,188,POINT (-83.28275743002158 9.584811980985961),-83.28275743002158,9.584811980985961
2329,25,41,133,199,POINT (-83.28275743002158 9.62867598098596),-83.28275743002158,9.62867598098596
2330,28,46,135,209,POINT (-83.28275743002158 9.67253998098596),-83.28275743002158,9.67253998098596
2331,38,58,138,234,POINT (-83.28275743002158 9.716403980985959),-83.28275743002158,9.716403980985959
2332,41,64,138,243,POINT (-83.28275743002158 9.760267980985958),-83.28275743002158,9.760267980985958
2333,49,74,138,261,POINT (-83.28275743002158 9.804131980985957),-83.28275743002158,9.804131980985957
2334,52,78,139,269,POINT (-83.28275743002158 9.847995980985957),-83.28275743002158,9.847995980985957
2335,62,82,135,279,POINT (-83.28275743002158 9.891859980985956),-83.28275743002158,9.891859980985956
2336,60,87,134,281,POINT (-83.28275743002158 9.935723980985955),-83.28275743002158,9.935723980985955
2337,58,87,134,279,POINT (-83.28275743002158 9.979587980985954),-83.28275743002158,9.979587980985954
2338,57,86,130,273,POINT (-83.28275743002158 10.023451980985953),-83.28275743002158,10.023451980985953
2339,53,85,129,267,POINT (-83.28275743002158 10.067315980985953),-83.28275743002158,10.067315980985953
2340,48,84,127,259,POINT (-83.28275743002158 10.111179980985952),-83.28275743002158,10.111179980985952
2341,46,84,127,257,POINT (-83.28275743002158 10.155043980985951),-83.28275743002158,10.155043980985951
2342,45,82,125,252,POINT (-83.28275743002158 10.19890798098595),-83.28275743002158,10.19890798098595
2343,0,4,29,33,POINT (-83.28275743002158 10.24277198098595),-83.28275743002158,10.24277198098595
2344,0,6,26,32,POINT (-83.24682543002157 8.356619980985982),-83.24682543002157,8.356619980985982
2345,0,6,26,32,POINT (-83.24682543002157 8.400483980985982),-83.24682543002157,8.400483980985982
2346,0,6,26,32,POINT (-83.24682543002157 8.444347980985981),-83.24682543002157,8.444347980985981
2347,0,6,26,32,POINT (-83.24682543002157 8.48821198098598),-83.24682543002157,8.48821198098598
2348,0,6,26,32,POINT (-83.24682543002157 8.53207598098598),-83.24682543002157,8.53207598098598
2349,0,4,26,30,POINT (-83.24682543002157 8.575939980985979),-83.24682543002157,8.575939980985979
2350,0,4,26,30,POINT (-83.24682543002157 8.619803980985978),-83.24682543002157,8.619803980985978
2351,48,75,125,248,POINT (-83.24682543002157 8.663667980985977),-83.24682543002157,8.663667980985977
2352,50,77,125,252,POINT (-83.24682543002157 8.707531980985976),-83.24682543002157,8.707531980985976
2353,51,76,125,252,POINT (-83.24682543002157 8.751395980985976),-83.24682543002157,8.751395980985976
2354,50,75,127,252,POINT (-83.24682543002157 8.795259980985975),-83.24682543002157,8.795259980985975
2355,46,74,128,248,POINT (-83.24682543002157 8.839123980985974),-83.24682543002157,8.839123980985974
2356,47,73,135,255,POINT (-83.24682543002157 8.882987980985973),-83.24682543002157,8.882987980985973
2357,44,74,134,252,POINT (-83.24682543002157 8.926851980985973),-83.24682543002157,8.926851980985973
2358,41,71,131,243,POINT (-83.24682543002157 8.970715980985972),-83.24682543002157,8.970715980985972
2359,40,66,131,237,POINT (-83.24682543002157 9.014579980985971),-83.24682543002157,9.014579980985971
2360,34,61,127,222,POINT (-83.24682543002157 9.05844398098597),-83.24682543002157,9.05844398098597
2361,31,56,120,207,POINT (-83.24682543002157 9.10230798098597),-83.24682543002157,9.10230798098597
2362,25,50,116,191,POINT (-83.24682543002157 9.146171980985969),-83.24682543002157,9.146171980985969
2363,19,42,118,179,POINT (-83.24682543002157 9.190035980985968),-83.24682543002157,9.190035980985968
2364,18,25,122,165,POINT (-83.24682543002157 9.233899980985967),-83.24682543002157,9.233899980985967
2365,14,20,123,157,POINT (-83.24682543002157 9.277763980985966),-83.24682543002157,9.277763980985966
2366,10,18,123,151,POINT (-83.24682543002157 9.321627980985966),-83.24682543002157,9.321627980985966
2367,11,18,121,150,POINT (-83.24682543002157 9.365491980985965),-83.24682543002157,9.365491980985965
2368,11,21,120,152,POINT (-83.24682543002157 9.409355980985964),-83.24682543002157,9.409355980985964
2369,6,23,120,149,POINT (-83.24682543002157 9.453219980985963),-83.24682543002157,9.453219980985963
2370,13,33,124,170,POINT (-83.24682543002157 9.497083980985963),-83.24682543002157,9.497083980985963
2371,15,35,126,176,POINT (-83.24682543002157 9.540947980985962),-83.24682543002157,9.540947980985962
2372,21,41,131,193,POINT (-83.24682543002157 9.584811980985961),-83.24682543002157,9.584811980985961
2373,29,48,133,210,POINT (-83.24682543002157 9.62867598098596),-83.24682543002157,9.62867598098596
2374,34,52,133,219,POINT (-83.24682543002157 9.67253998098596),-83.24682543002157,9.67253998098596
2375,40,65,136,241,POINT (-83.24682543002157 9.716403980985959),-83.24682543002157,9.716403980985959
2376,43,66,139,248,POINT (-83.24682543002157 9.760267980985958),-83.24682543002157,9.760267980985958
2377,48,67,140,255,POINT (-83.24682543002157 9.804131980985957),-83.24682543002157,9.804131980985957
2378,55,75,138,268,POINT (-83.24682543002157 9.847995980985957),-83.24682543002157,9.847995980985957
2379,64,86,132,282,POINT (-83.24682543002157 9.891859980985956),-83.24682543002157,9.891859980985956
2380,62,87,134,283,POINT (-83.24682543002157 9.935723980985955),-83.24682543002157,9.935723980985955
2381,59,87,129,275,POINT (-83.24682543002157 9.979587980985954),-83.24682543002157,9.979587980985954
2382,55,85,130,270,POINT (-83.24682543002157 10.023451980985953),-83.24682543002157,10.023451980985953
2383,51,85,127,263,POINT (-83.24682543002157 10.067315980985953),-83.24682543002157,10.067315980985953
2384,47,84,127,258,POINT (-83.24682543002157 10.111179980985952),-83.24682543002157,10.111179980985952
2385,46,84,125,255,POINT (-83.24682543002157 10.155043980985951),-83.24682543002157,10.155043980985951
2386,0,4,29,33,POINT (-83.24682543002157 10.19890798098595),-83.24682543002157,10.19890798098595
2387,0,6,26,32,POINT (-83.21089343002157 8.356619980985982),-83.21089343002157,8.356619980985982
2388,0,6,26,32,POINT (-83.21089343002157 8.400483980985982),-83.21089343002157,8.400483980985982
2389,0,6,26,32,POINT (-83.21089343002157 8.444347980985981),-83.21089343002157,8.444347980985981
2390,0,6,26,32,POINT (-83.21089343002157 8.48821198098598),-83.21089343002157,8.48821198098598
2391,0,4,26,30,POINT (-83.21089343002157 8.53207598098598),-83.21089343002157,8.53207598098598
2392,0,4,26,30,POINT (-83.21089343002157 8.575939980985979),-83.21089343002157,8.575939980985979
2393,0,7,26,33,POINT (-83.21089343002157 8.619803980985978),-83.21089343002157,8.619803980985978
2394,49,77,126,252,POINT (-83.21089343002157 8.663667980985977),-83.21089343002157,8.663667980985977
2395,50,79,127,256,POINT (-83.21089343002157 8.707531980985976),-83.21089343002157,8.707531980985976
2396,50,78,126,254,POINT (-83.21089343002157 8.751395980985976),-83.21089343002157,8.751395980985976
2397,47,75,129,251,POINT (-83.21089343002157 8.795259980985975),-83.21089343002157,8.795259980985975
2398,46,71,132,249,POINT (-83.21089343002157 8.839123980985974),-83.21089343002157,8.839123980985974
2399,42,72,136,250,POINT (-83.21089343002157 8.882987980985973),-83.21089343002157,8.882987980985973
2400,41,72,134,247,POINT (-83.21089343002157 8.926851980985973),-83.21089343002157,8.926851980985973
2401,39,67,134,240,POINT (-83.21089343002157 8.970715980985972),-83.21089343002157,8.970715980985972
2402,37,62,130,229,POINT (-83.21089343002157 9.014579980985971),-83.21089343002157,9.014579980985971
2403,33,58,128,219,POINT (-83.21089343002157 9.05844398098597),-83.21089343002157,9.05844398098597
2404,29,53,118,200,POINT (-83.21089343002157 9.10230798098597),-83.21089343002157,9.10230798098597
2405,22,45,117,184,POINT (-83.21089343002157 9.146171980985969),-83.21089343002157,9.146171980985969
2406,18,32,117,167,POINT (-83.21089343002157 9.190035980985968),-83.21089343002157,9.190035980985968
2407,16,20,123,159,POINT (-83.21089343002157 9.233899980985967),-83.21089343002157,9.233899980985967
2408,11,19,122,152,POINT (-83.21089343002157 9.277763980985966),-83.21089343002157,9.277763980985966
2409,10,16,122,148,POINT (-83.21089343002157 9.321627980985966),-83.21089343002157,9.321627980985966
2410,14,19,120,153,POINT (-83.21089343002157 9.365491980985965),-83.21089343002157,9.365491980985965
2411,14,24,121,159,POINT (-83.21089343002157 9.409355980985964),-83.21089343002157,9.409355980985964
2412,12,31,121,164,POINT (-83.21089343002157 9.453219980985963),-83.21089343002157,9.453219980985963
2413,13,34,126,173,POINT (-83.21089343002157 9.497083980985963),-83.21089343002157,9.497083980985963
2414,18,39,133,190,POINT (-83.21089343002157 9.540947980985962),-83.21089343002157,9.540947980985962
2415,28,42,131,201,POINT (-83.21089343002157 9.584811980985961),-83.21089343002157,9.584811980985961
2416,31,56,130,217,POINT (-83.21089343002157 9.62867598098596),-83.21089343002157,9.62867598098596
2417,40,59,134,233,POINT (-83.21089343002157 9.67253998098596),-83.21089343002157,9.67253998098596
2418,43,67,137,247,POINT (-83.21089343002157 9.716403980985959),-83.21089343002157,9.716403980985959
2419,47,72,138,257,POINT (-83.21089343002157 9.760267980985958),-83.21089343002157,9.760267980985958
2420,50,73,141,264,POINT (-83.21089343002157 9.804131980985957),-83.21089343002157,9.804131980985957
2421,60,84,137,281,POINT (-83.21089343002157 9.847995980985957),-83.21089343002157,9.847995980985957
2422,66,89,136,291,POINT (-83.21089343002157 9.891859980985956),-83.21089343002157,9.891859980985956
2423,64,87,130,281,POINT (-83.21089343002157 9.935723980985955),-83.21089343002157,9.935723980985955
2424,57,87,129,273,POINT (-83.21089343002157 9.979587980985954),-83.21089343002157,9.979587980985954
2425,53,85,129,267,POINT (-83.21089343002157 10.023451980985953),-83.21089343002157,10.023451980985953
2426,47,85,127,259,POINT (-83.21089343002157 10.067315980985953),-83.21089343002157,10.067315980985953
2427,46,68,125,239,POINT (-83.21089343002157 10.111179980985952),-83.21089343002157,10.111179980985952
2428,0,4,29,33,POINT (-83.21089343002157 10.155043980985951),-83.21089343002157,10.155043980985951
2429,0,6,26,32,POINT (-83.17496143002157 8.312755980985983),-83.17496143002157,8.312755980985983
2430,0,6,26,32,POINT (-83.17496143002157 8.356619980985982),-83.17496143002157,8.356619980985982
2431,0,6,26,32,POINT (-83.17496143002157 8.400483980985982),-83.17496143002157,8.400483980985982
2432,0,6,26,32,POINT (-83.17496143002157 8.444347980985981),-83.17496143002157,8.444347980985981
2433,0,4,26,30,POINT (-83.17496143002157 8.48821198098598),-83.17496143002157,8.48821198098598
2434,0,4,26,30,POINT (-83.17496143002157 8.53207598098598),-83.17496143002157,8.53207598098598
2435,0,6,26,32,POINT (-83.17496143002157 8.575939980985979),-83.17496143002157,8.575939980985979
2436,0,7,26,33,POINT (-83.17496143002157 8.619803980985978),-83.17496143002157,8.619803980985978
2437,49,77,128,254,POINT (-83.17496143002157 8.663667980985977),-83.17496143002157,8.663667980985977
2438,49,79,128,256,POINT (-83.17496143002157 8.707531980985976),-83.17496143002157,8.707531980985976
2439,47,78,130,255,POINT (-83.17496143002157 8.751395980985976),-83.17496143002157,8.751395980985976
2440,46,72,131,249,POINT (-83.17496143002157 8.795259980985975),-83.17496143002157,8.795259980985975
2441,41,67,136,244,POINT (-83.17496143002157 8.839123980985974),-83.17496143002157,8.839123980985974
2442,42,70,137,249,POINT (-83.17496143002157 8.882987980985973),-83.17496143002157,8.882987980985973
2443,39,66,135,240,POINT (-83.17496143002157 8.926851980985973),-83.17496143002157,8.926851980985973
2444,38,63,131,232,POINT (-83.17496143002157 8.970715980985972),-83.17496143002157,8.970715980985972
2445,36,60,128,224,POINT (-83.17496143002157 9.014579980985971),-83.17496143002157,9.014579980985971
2446,32,56,119,207,POINT (-83.17496143002157 9.05844398098597),-83.17496143002157,9.05844398098597
2447,26,50,115,191,POINT (-83.17496143002157 9.10230798098597),-83.17496143002157,9.10230798098597
2448,19,37,118,174,POINT (-83.17496143002157 9.146171980985969),-83.17496143002157,9.146171980985969
2449,18,21,121,160,POINT (-83.17496143002157 9.190035980985968),-83.17496143002157,9.190035980985968
2450,13,18,121,152,POINT (-83.17496143002157 9.233899980985967),-83.17496143002157,9.233899980985967
2451,10,19,121,150,POINT (-83.17496143002157 9.277763980985966),-83.17496143002157,9.277763980985966
2452,10,16,122,148,POINT (-83.17496143002157 9.321627980985966),-83.17496143002157,9.321627980985966
2453,10,20,123,153,POINT (-83.17496143002157 9.365491980985965),-83.17496143002157,9.365491980985965
2454,10,24,120,154,POINT (-83.17496143002157 9.409355980985964),-83.17496143002157,9.409355980985964
2455,13,34,123,170,POINT (-83.17496143002157 9.453219980985963),-83.17496143002157,9.453219980985963
2456,19,34,130,183,POINT (-83.17496143002157 9.497083980985963),-83.17496143002157,9.497083980985963
2457,23,39,132,194,POINT (-83.17496143002157 9.540947980985962),-83.17496143002157,9.540947980985962
2458,30,51,131,212,POINT (-83.17496143002157 9.584811980985961),-83.17496143002157,9.584811980985961
2459,37,64,132,233,POINT (-83.17496143002157 9.62867598098596),-83.17496143002157,9.62867598098596
2460,40,68,134,242,POINT (-83.17496143002157 9.67253998098596),-83.17496143002157,9.67253998098596
2461,45,73,137,255,POINT (-83.17496143002157 9.716403980985959),-83.17496143002157,9.716403980985959
2462,50,78,137,265,POINT (-83.17496143002157 9.760267980985958),-83.17496143002157,9.760267980985958
2463,56,76,138,270,POINT (-83.17496143002157 9.804131980985957),-83.17496143002157,9.804131980985957
2464,61,85,137,283,POINT (-83.17496143002157 9.847995980985957),-83.17496143002157,9.847995980985957
2465,64,88,133,285,POINT (-83.17496143002157 9.891859980985956),-83.17496143002157,9.891859980985956
2466,60,87,130,277,POINT (-83.17496143002157 9.935723980985955),-83.17496143002157,9.935723980985955
2467,53,83,127,263,POINT (-83.17496143002157 9.979587980985954),-83.17496143002157,9.979587980985954
2468,49,84,127,260,POINT (-83.17496143002157 10.023451980985953),-83.17496143002157,10.023451980985953
2469,46,85,127,258,POINT (-83.17496143002157 10.067315980985953),-83.17496143002157,10.067315980985953
2470,0,4,29,33,POINT (-83.17496143002157 10.111179980985952),-83.17496143002157,10.111179980985952
2471,0,5,29,34,POINT (-83.17496143002157 10.155043980985951),-83.17496143002157,10.155043980985951
2472,0,6,26,32,POINT (-83.13902943002157 8.312755980985983),-83.13902943002157,8.312755980985983
2473,35,50,115,200,POINT (-83.13902943002157 8.356619980985982),-83.13902943002157,8.356619980985982
2474,0,7,26,33,POINT (-83.13902943002157 8.400483980985982),-83.13902943002157,8.400483980985982
2475,0,4,26,30,POINT (-83.13902943002157 8.444347980985981),-83.13902943002157,8.444347980985981
2476,0,4,26,30,POINT (-83.13902943002157 8.48821198098598),-83.13902943002157,8.48821198098598
2477,41,65,118,224,POINT (-83.13902943002157 8.53207598098598),-83.13902943002157,8.53207598098598
2478,40,69,127,236,POINT (-83.13902943002157 8.575939980985979),-83.13902943002157,8.575939980985979
2479,42,72,127,241,POINT (-83.13902943002157 8.619803980985978),-83.13902943002157,8.619803980985978
2480,46,78,127,251,POINT (-83.13902943002157 8.663667980985977),-83.13902943002157,8.663667980985977
2481,47,76,128,251,POINT (-83.13902943002157 8.707531980985976),-83.13902943002157,8.707531980985976
2482,46,73,131,250,POINT (-83.13902943002157 8.751395980985976),-83.13902943002157,8.751395980985976
2483,44,63,136,243,POINT (-83.13902943002157 8.795259980985975),-83.13902943002157,8.795259980985975
2484,41,67,137,245,POINT (-83.13902943002157 8.839123980985974),-83.13902943002157,8.839123980985974
2485,42,68,137,247,POINT (-83.13902943002157 8.882987980985973),-83.13902943002157,8.882987980985973
2486,39,64,136,239,POINT (-83.13902943002157 8.926851980985973),-83.13902943002157,8.926851980985973
2487,37,62,128,227,POINT (-83.13902943002157 8.970715980985972),-83.13902943002157,8.970715980985972
2488,34,58,124,216,POINT (-83.13902943002157 9.014579980985971),-83.13902943002157,9.014579980985971
2489,31,52,117,200,POINT (-83.13902943002157 9.05844398098597),-83.13902943002157,9.05844398098597
2490,24,44,118,186,POINT (-83.13902943002157 9.10230798098597),-83.13902943002157,9.10230798098597
2491,18,28,121,167,POINT (-83.13902943002157 9.146171980985969),-83.13902943002157,9.146171980985969
2492,14,20,122,156,POINT (-83.13902943002157 9.190035980985968),-83.13902943002157,9.190035980985968
2493,10,20,121,151,POINT (-83.13902943002157 9.233899980985967),-83.13902943002157,9.233899980985967
2494,9,17,121,147,POINT (-83.13902943002157 9.277763980985966),-83.13902943002157,9.277763980985966
2495,10,21,121,152,POINT (-83.13902943002157 9.321627980985966),-83.13902943002157,9.321627980985966
2496,10,24,121,155,POINT (-83.13902943002157 9.365491980985965),-83.13902943002157,9.365491980985965
2497,12,27,121,160,POINT (-83.13902943002157 9.409355980985964),-83.13902943002157,9.409355980985964
2498,15,34,129,178,POINT (-83.13902943002157 9.453219980985963),-83.13902943002157,9.453219980985963
2499,19,45,130,194,POINT (-83.13902943002157 9.497083980985963),-83.13902943002157,9.497083980985963
2500,30,46,129,205,POINT (-83.13902943002157 9.540947980985962),-83.13902943002157,9.540947980985962
2501,37,60,127,224,POINT (-83.13902943002157 9.584811980985961),-83.13902943002157,9.584811980985961
2502,39,71,132,242,POINT (-83.13902943002157 9.62867598098596),-83.13902943002157,9.62867598098596
2503,42,75,134,251,POINT (-83.13902943002157 9.67253998098596),-83.13902943002157,9.67253998098596
2504,50,80,132,262,POINT (-83.13902943002157 9.716403980985959),-83.13902943002157,9.716403980985959
2505,54,81,137,272,POINT (-83.13902943002157 9.760267980985958),-83.13902943002157,9.760267980985958
2506,60,83,137,280,POINT (-83.13902943002157 9.804131980985957),-83.13902943002157,9.804131980985957
2507,60,90,135,285,POINT (-83.13902943002157 9.847995980985957),-83.13902943002157,9.847995980985957
2508,58,89,130,277,POINT (-83.13902943002157 9.891859980985956),-83.13902943002157,9.891859980985956
2509,54,83,128,265,POINT (-83.13902943002157 9.935723980985955),-83.13902943002157,9.935723980985955
2510,54,83,127,264,POINT (-83.13902943002157 9.979587980985954),-83.13902943002157,9.979587980985954
2511,47,81,127,255,POINT (-83.13902943002157 10.023451980985953),-83.13902943002157,10.023451980985953
2512,0,4,29,33,POINT (-83.13902943002157 10.067315980985953),-83.13902943002157,10.067315980985953
2513,0,5,29,34,POINT (-83.13902943002157 10.111179980985952),-83.13902943002157,10.111179980985952
2514,0,8,26,34,POINT (-83.10309743002156 8.312755980985983),-83.10309743002156,8.312755980985983
2515,36,62,126,224,POINT (-83.10309743002156 8.356619980985982),-83.10309743002156,8.356619980985982
2516,37,60,126,223,POINT (-83.10309743002156 8.400483980985982),-83.10309743002156,8.400483980985982
2517,0,7,26,33,POINT (-83.10309743002156 8.444347980985981),-83.10309743002156,8.444347980985981
2518,40,64,126,230,POINT (-83.10309743002156 8.48821198098598),-83.10309743002156,8.48821198098598
2519,41,70,127,238,POINT (-83.10309743002156 8.53207598098598),-83.10309743002156,8.53207598098598
2520,42,72,128,242,POINT (-83.10309743002156 8.575939980985979),-83.10309743002156,8.575939980985979
2521,42,73,128,243,POINT (-83.10309743002156 8.619803980985978),-83.10309743002156,8.619803980985978
2522,45,74,127,246,POINT (-83.10309743002156 8.663667980985977),-83.10309743002156,8.663667980985977
2523,45,71,130,246,POINT (-83.10309743002156 8.707531980985976),-83.10309743002156,8.707531980985976
2524,44,71,131,246,POINT (-83.10309743002156 8.751395980985976),-83.10309743002156,8.751395980985976
2525,39,65,138,242,POINT (-83.10309743002156 8.795259980985975),-83.10309743002156,8.795259980985975
2526,43,68,140,251,POINT (-83.10309743002156 8.839123980985974),-83.10309743002156,8.839123980985974
2527,39,66,137,242,POINT (-83.10309743002156 8.882987980985973),-83.10309743002156,8.882987980985973
2528,39,64,130,233,POINT (-83.10309743002156 8.926851980985973),-83.10309743002156,8.926851980985973
2529,36,59,131,226,POINT (-83.10309743002156 8.970715980985972),-83.10309743002156,8.970715980985972
2530,33,56,120,209,POINT (-83.10309743002156 9.014579980985971),-83.10309743002156,9.014579980985971
2531,29,44,117,190,POINT (-83.10309743002156 9.05844398098597),-83.10309743002156,9.05844398098597
2532,20,33,119,172,POINT (-83.10309743002156 9.10230798098597),-83.10309743002156,9.10230798098597
2533,14,23,123,160,POINT (-83.10309743002156 9.146171980985969),-83.10309743002156,9.146171980985969
2534,8,20,123,151,POINT (-83.10309743002156 9.190035980985968),-83.10309743002156,9.190035980985968
2535,8,18,118,144,POINT (-83.10309743002156 9.233899980985967),-83.10309743002156,9.233899980985967
2536,8,20,120,148,POINT (-83.10309743002156 9.277763980985966),-83.10309743002156,9.277763980985966
2537,13,23,122,158,POINT (-83.10309743002156 9.321627980985966),-83.10309743002156,9.321627980985966
2538,12,30,119,161,POINT (-83.10309743002156 9.365491980985965),-83.10309743002156,9.365491980985965
2539,13,36,122,171,POINT (-83.10309743002156 9.409355980985964),-83.10309743002156,9.409355980985964
2540,19,38,131,188,POINT (-83.10309743002156 9.453219980985963),-83.10309743002156,9.453219980985963
2541,25,47,128,200,POINT (-83.10309743002156 9.497083980985963),-83.10309743002156,9.497083980985963
2542,34,59,129,222,POINT (-83.10309743002156 9.540947980985962),-83.10309743002156,9.540947980985962
2543,40,73,131,244,POINT (-83.10309743002156 9.584811980985961),-83.10309743002156,9.584811980985961
2544,45,79,132,256,POINT (-83.10309743002156 9.62867598098596),-83.10309743002156,9.62867598098596
2545,50,83,132,265,POINT (-83.10309743002156 9.67253998098596),-83.10309743002156,9.67253998098596
2546,53,85,133,271,POINT (-83.10309743002156 9.716403980985959),-83.10309743002156,9.716403980985959
2547,55,82,133,270,POINT (-83.10309743002156 9.760267980985958),-83.10309743002156,9.760267980985958
2548,58,85,132,275,POINT (-83.10309743002156 9.804131980985957),-83.10309743002156,9.804131980985957
2549,57,88,129,274,POINT (-83.10309743002156 9.847995980985957),-83.10309743002156,9.847995980985957
2550,54,83,129,266,POINT (-83.10309743002156 9.891859980985956),-83.10309743002156,9.891859980985956
2551,51,83,127,261,POINT (-83.10309743002156 9.935723980985955),-83.10309743002156,9.935723980985955
2552,49,84,125,258,POINT (-83.10309743002156 9.979587980985954),-83.10309743002156,9.979587980985954
2553,0,4,29,33,POINT (-83.10309743002156 10.023451980985953),-83.10309743002156,10.023451980985953
2554,0,3,29,32,POINT (-83.10309743002156 10.067315980985953),-83.10309743002156,10.067315980985953
2555,0,6,25,31,POINT (-83.06716543002156 8.268891980985984),-83.06716543002156,8.268891980985984
2556,34,61,127,222,POINT (-83.06716543002156 8.312755980985983),-83.06716543002156,8.312755980985983
2557,35,62,126,223,POINT (-83.06716543002156 8.356619980985982),-83.06716543002156,8.356619980985982
2558,38,62,126,226,POINT (-83.06716543002156 8.400483980985982),-83.06716543002156,8.400483980985982
2559,38,63,126,227,POINT (-83.06716543002156 8.444347980985981),-83.06716543002156,8.444347980985981
2560,40,67,126,233,POINT (-83.06716543002156 8.48821198098598),-83.06716543002156,8.48821198098598
2561,40,70,126,236,POINT (-83.06716543002156 8.53207598098598),-83.06716543002156,8.53207598098598
2562,40,72,127,239,POINT (-83.06716543002156 8.575939980985979),-83.06716543002156,8.575939980985979
2563,41,72,128,241,POINT (-83.06716543002156 8.619803980985978),-83.06716543002156,8.619803980985978
2564,43,71,130,244,POINT (-83.06716543002156 8.663667980985977),-83.06716543002156,8.663667980985977
2565,45,70,129,244,POINT (-83.06716543002156 8.707531980985976),-83.06716543002156,8.707531980985976
2566,43,69,137,249,POINT (-83.06716543002156 8.751395980985976),-83.06716543002156,8.751395980985976
2567,41,66,138,245,POINT (-83.06716543002156 8.795259980985975),-83.06716543002156,8.795259980985975
2568,41,68,138,247,POINT (-83.06716543002156 8.839123980985974),-83.06716543002156,8.839123980985974
2569,40,62,133,235,POINT (-83.06716543002156 8.882987980985973),-83.06716543002156,8.882987980985973
2570,38,61,131,230,POINT (-83.06716543002156 8.926851980985973),-83.06716543002156,8.926851980985973
2571,34,59,119,212,POINT (-83.06716543002156 8.970715980985972),-83.06716543002156,8.970715980985972
2572,31,50,118,199,POINT (-83.06716543002156 9.014579980985971),-83.06716543002156,9.014579980985971
2573,24,41,119,184,POINT (-83.06716543002156 9.05844398098597),-83.06716543002156,9.05844398098597
2574,16,24,123,163,POINT (-83.06716543002156 9.10230798098597),-83.06716543002156,9.10230798098597
2575,10,18,124,152,POINT (-83.06716543002156 9.146171980985969),-83.06716543002156,9.146171980985969
2576,9,18,119,146,POINT (-83.06716543002156 9.190035980985968),-83.06716543002156,9.190035980985968
2577,9,18,118,145,POINT (-83.06716543002156 9.233899980985967),-83.06716543002156,9.233899980985967
2578,6,23,121,150,POINT (-83.06716543002156 9.277763980985966),-83.06716543002156,9.277763980985966
2579,10,29,121,160,POINT (-83.06716543002156 9.321627980985966),-83.06716543002156,9.321627980985966
2580,12,35,121,168,POINT (-83.06716543002156 9.365491980985965),-83.06716543002156,9.365491980985965
2581,16,39,130,185,POINT (-83.06716543002156 9.409355980985964),-83.06716543002156,9.409355980985964
2582,23,43,131,197,POINT (-83.06716543002156 9.453219980985963),-83.06716543002156,9.453219980985963
2583,34,56,130,220,POINT (-83.06716543002156 9.497083980985963),-83.06716543002156,9.497083980985963
2584,44,66,130,240,POINT (-83.06716543002156 9.540947980985962),-83.06716543002156,9.540947980985962
2585,46,80,132,258,POINT (-83.06716543002156 9.584811980985961),-83.06716543002156,9.584811980985961
2586,50,83,133,266,POINT (-83.06716543002156 9.62867598098596),-83.06716543002156,9.62867598098596
2587,54,85,132,271,POINT (-83.06716543002156 9.67253998098596),-83.06716543002156,9.67253998098596
2588,56,88,131,275,POINT (-83.06716543002156 9.716403980985959),-83.06716543002156,9.716403980985959
2589,58,88,133,279,POINT (-83.06716543002156 9.760267980985958),-83.06716543002156,9.760267980985958
2590,58,87,130,275,POINT (-83.06716543002156 9.804131980985957),-83.06716543002156,9.804131980985957
2591,56,85,128,269,POINT (-83.06716543002156 9.847995980985957),-83.06716543002156,9.847995980985957
2592,54,83,127,264,POINT (-83.06716543002156 9.891859980985956),-83.06716543002156,9.891859980985956
2593,51,83,126,260,POINT (-83.06716543002156 9.935723980985955),-83.06716543002156,9.935723980985955
2594,45,82,125,252,POINT (-83.06716543002156 9.979587980985954),-83.06716543002156,9.979587980985954
2595,0,3,29,32,POINT (-83.06716543002156 10.023451980985953),-83.06716543002156,10.023451980985953
2596,0,6,25,31,POINT (-83.03123343002156 8.268891980985984),-83.03123343002156,8.268891980985984
2597,30,63,126,219,POINT (-83.03123343002156 8.312755980985983),-83.03123343002156,8.312755980985983
2598,34,61,127,222,POINT (-83.03123343002156 8.356619980985982),-83.03123343002156,8.356619980985982
2599,36,61,126,223,POINT (-83.03123343002156 8.400483980985982),-83.03123343002156,8.400483980985982
2600,37,61,126,224,POINT (-83.03123343002156 8.444347980985981),-83.03123343002156,8.444347980985981
2601,39,66,126,231,POINT (-83.03123343002156 8.48821198098598),-83.03123343002156,8.48821198098598
2602,39,66,127,232,POINT (-83.03123343002156 8.53207598098598),-83.03123343002156,8.53207598098598
2603,39,71,127,237,POINT (-83.03123343002156 8.575939980985979),-83.03123343002156,8.575939980985979
2604,41,72,129,242,POINT (-83.03123343002156 8.619803980985978),-83.03123343002156,8.619803980985978
2605,42,70,129,241,POINT (-83.03123343002156 8.663667980985977),-83.03123343002156,8.663667980985977
2606,45,71,131,247,POINT (-83.03123343002156 8.707531980985976),-83.03123343002156,8.707531980985976
2607,45,66,137,248,POINT (-83.03123343002156 8.751395980985976),-83.03123343002156,8.751395980985976
2608,40,65,140,245,POINT (-83.03123343002156 8.795259980985975),-83.03123343002156,8.795259980985975
2609,41,64,136,241,POINT (-83.03123343002156 8.839123980985974),-83.03123343002156,8.839123980985974
2610,38,63,133,234,POINT (-83.03123343002156 8.882987980985973),-83.03123343002156,8.882987980985973
2611,35,59,129,223,POINT (-83.03123343002156 8.926851980985973),-83.03123343002156,8.926851980985973
2612,34,54,116,204,POINT (-83.03123343002156 8.970715980985972),-83.03123343002156,8.970715980985972
2613,28,44,120,192,POINT (-83.03123343002156 9.014579980985971),-83.03123343002156,9.014579980985971
2614,18,28,122,168,POINT (-83.03123343002156 9.05844398098597),-83.03123343002156,9.05844398098597
2615,17,21,124,162,POINT (-83.03123343002156 9.10230798098597),-83.03123343002156,9.10230798098597
2616,7,19,119,145,POINT (-83.03123343002156 9.146171980985969),-83.03123343002156,9.146171980985969
2617,8,18,119,145,POINT (-83.03123343002156 9.190035980985968),-83.03123343002156,9.190035980985968
2618,7,21,120,148,POINT (-83.03123343002156 9.233899980985967),-83.03123343002156,9.233899980985967
2619,7,22,121,150,POINT (-83.03123343002156 9.277763980985966),-83.03123343002156,9.277763980985966
2620,7,34,119,160,POINT (-83.03123343002156 9.321627980985966),-83.03123343002156,9.321627980985966
2621,15,36,129,180,POINT (-83.03123343002156 9.365491980985965),-83.03123343002156,9.365491980985965
2622,24,45,128,197,POINT (-83.03123343002156 9.409355980985964),-83.03123343002156,9.409355980985964
2623,32,51,129,212,POINT (-83.03123343002156 9.453219980985963),-83.03123343002156,9.453219980985963
2624,43,66,130,239,POINT (-83.03123343002156 9.497083980985963),-83.03123343002156,9.497083980985963
2625,43,75,132,250,POINT (-83.03123343002156 9.540947980985962),-83.03123343002156,9.540947980985962
2626,46,87,132,265,POINT (-83.03123343002156 9.584811980985961),-83.03123343002156,9.584811980985961
2627,54,85,131,270,POINT (-83.03123343002156 9.62867598098596),-83.03123343002156,9.62867598098596
2628,56,88,131,275,POINT (-83.03123343002156 9.67253998098596),-83.03123343002156,9.67253998098596
2629,61,87,134,282,POINT (-83.03123343002156 9.716403980985959),-83.03123343002156,9.716403980985959
2630,59,87,131,277,POINT (-83.03123343002156 9.760267980985958),-83.03123343002156,9.760267980985958
2631,57,88,129,274,POINT (-83.03123343002156 9.804131980985957),-83.03123343002156,9.804131980985957
2632,56,84,127,267,POINT (-83.03123343002156 9.847995980985957),-83.03123343002156,9.847995980985957
2633,52,83,126,261,POINT (-83.03123343002156 9.891859980985956),-83.03123343002156,9.891859980985956
2634,48,81,126,255,POINT (-83.03123343002156 9.935723980985955),-83.03123343002156,9.935723980985955
2635,0,7,38,45,POINT (-83.03123343002156 9.979587980985954),-83.03123343002156,9.979587980985954
2636,31,61,125,217,POINT (-82.99530143002156 8.268891980985984),-82.99530143002156,8.268891980985984
2637,31,63,126,220,POINT (-82.99530143002156 8.312755980985983),-82.99530143002156,8.312755980985983
2638,32,62,128,222,POINT (-82.99530143002156 8.356619980985982),-82.99530143002156,8.356619980985982
2639,36,60,126,222,POINT (-82.99530143002156 8.400483980985982),-82.99530143002156,8.400483980985982
2640,37,62,126,225,POINT (-82.99530143002156 8.444347980985981),-82.99530143002156,8.444347980985981
2641,38,63,127,228,POINT (-82.99530143002156 8.48821198098598),-82.99530143002156,8.48821198098598
2642,38,68,127,233,POINT (-82.99530143002156 8.53207598098598),-82.99530143002156,8.53207598098598
2643,38,72,128,238,POINT (-82.99530143002156 8.575939980985979),-82.99530143002156,8.575939980985979
2644,41,69,128,238,POINT (-82.99530143002156 8.619803980985978),-82.99530143002156,8.619803980985978
2645,42,70,129,241,POINT (-82.99530143002156 8.663667980985977),-82.99530143002156,8.663667980985977
2646,42,72,137,251,POINT (-82.99530143002156 8.707531980985976),-82.99530143002156,8.707531980985976
2647,45,66,137,248,POINT (-82.99530143002156 8.751395980985976),-82.99530143002156,8.751395980985976
2648,42,66,138,246,POINT (-82.99530143002156 8.795259980985975),-82.99530143002156,8.795259980985975
2649,40,66,137,243,POINT (-82.99530143002156 8.839123980985974),-82.99530143002156,8.839123980985974
2650,39,61,130,230,POINT (-82.99530143002156 8.882987980985973),-82.99530143002156,8.882987980985973
2651,36,56,122,214,POINT (-82.99530143002156 8.926851980985973),-82.99530143002156,8.926851980985973
2652,31,47,119,197,POINT (-82.99530143002156 8.970715980985972),-82.99530143002156,8.970715980985972
2653,27,32,121,180,POINT (-82.99530143002156 9.014579980985971),-82.99530143002156,9.014579980985971
2654,19,25,123,167,POINT (-82.99530143002156 9.05844398098597),-82.99530143002156,9.05844398098597
2655,10,22,120,152,POINT (-82.99530143002156 9.10230798098597),-82.99530143002156,9.10230798098597
2656,9,19,119,147,POINT (-82.99530143002156 9.146171980985969),-82.99530143002156,9.146171980985969
2657,7,20,120,147,POINT (-82.99530143002156 9.190035980985968),-82.99530143002156,9.190035980985968
2658,6,21,123,150,POINT (-82.99530143002156 9.233899980985967),-82.99530143002156,9.233899980985967
2659,4,31,120,155,POINT (-82.99530143002156 9.277763980985966),-82.99530143002156,9.277763980985966
2660,7,32,124,163,POINT (-82.99530143002156 9.321627980985966),-82.99530143002156,9.321627980985966
2661,14,39,129,182,POINT (-82.99530143002156 9.365491980985965),-82.99530143002156,9.365491980985965
2662,28,49,132,209,POINT (-82.99530143002156 9.409355980985964),-82.99530143002156,9.409355980985964
2663,41,65,130,236,POINT (-82.99530143002156 9.453219980985963),-82.99530143002156,9.453219980985963
2664,43,76,132,251,POINT (-82.99530143002156 9.497083980985963),-82.99530143002156,9.497083980985963
2665,46,86,132,264,POINT (-82.99530143002156 9.540947980985962),-82.99530143002156,9.540947980985962
2666,49,86,131,266,POINT (-82.99530143002156 9.584811980985961),-82.99530143002156,9.584811980985961
2667,57,85,131,273,POINT (-82.99530143002156 9.62867598098596),-82.99530143002156,9.62867598098596
2668,58,87,134,279,POINT (-82.99530143002156 9.67253998098596),-82.99530143002156,9.67253998098596
2669,59,87,133,279,POINT (-82.99530143002156 9.716403980985959),-82.99530143002156,9.716403980985959
2670,58,87,129,274,POINT (-82.99530143002156 9.760267980985958),-82.99530143002156,9.760267980985958
2671,56,85,128,269,POINT (-82.99530143002156 9.804131980985957),-82.99530143002156,9.804131980985957
2672,54,82,126,262,POINT (-82.99530143002156 9.847995980985957),-82.99530143002156,9.847995980985957
2673,49,81,126,256,POINT (-82.99530143002156 9.891859980985956),-82.99530143002156,9.891859980985956
2674,0,4,29,33,POINT (-82.99530143002156 9.935723980985955),-82.99530143002156,9.935723980985955
2675,29,63,125,217,POINT (-82.95936943002155 8.268891980985984),-82.95936943002155,8.268891980985984
2676,30,63,125,218,POINT (-82.95936943002155 8.312755980985983),-82.95936943002155,8.312755980985983
2677,30,63,126,219,POINT (-82.95936943002155 8.356619980985982),-82.95936943002155,8.356619980985982
2678,35,62,129,226,POINT (-82.95936943002155 8.400483980985982),-82.95936943002155,8.400483980985982
2679,37,62,127,226,POINT (-82.95936943002155 8.444347980985981),-82.95936943002155,8.444347980985981
2680,36,64,127,227,POINT (-82.95936943002155 8.48821198098598),-82.95936943002155,8.48821198098598
2681,38,66,128,232,POINT (-82.95936943002155 8.53207598098598),-82.95936943002155,8.53207598098598
2682,38,70,128,236,POINT (-82.95936943002155 8.575939980985979),-82.95936943002155,8.575939980985979
2683,40,68,129,237,POINT (-82.95936943002155 8.619803980985978),-82.95936943002155,8.619803980985978
2684,39,71,130,240,POINT (-82.95936943002155 8.663667980985977),-82.95936943002155,8.663667980985977
2685,43,68,137,248,POINT (-82.95936943002155 8.707531980985976),-82.95936943002155,8.707531980985976
2686,49,68,137,254,POINT (-82.95936943002155 8.751395980985976),-82.95936943002155,8.751395980985976
2687,51,65,136,252,POINT (-82.95936943002155 8.795259980985975),-82.95936943002155,8.795259980985975
2688,39,64,133,236,POINT (-82.95936943002155 8.839123980985974),-82.95936943002155,8.839123980985974
2689,36,59,131,226,POINT (-82.95936943002155 8.882987980985973),-82.95936943002155,8.882987980985973
2690,32,53,119,204,POINT (-82.95936943002155 8.926851980985973),-82.95936943002155,8.926851980985973
2691,28,41,117,186,POINT (-82.95936943002155 8.970715980985972),-82.95936943002155,8.970715980985972
2692,19,30,122,171,POINT (-82.95936943002155 9.014579980985971),-82.95936943002155,9.014579980985971
2693,20,24,124,168,POINT (-82.95936943002155 9.05844398098597),-82.95936943002155,9.05844398098597
2694,13,18,119,150,POINT (-82.95936943002155 9.10230798098597),-82.95936943002155,9.10230798098597
2695,7,20,119,146,POINT (-82.95936943002155 9.146171980985969),-82.95936943002155,9.146171980985969
2696,7,21,122,150,POINT (-82.95936943002155 9.190035980985968),-82.95936943002155,9.190035980985968
2697,8,31,120,159,POINT (-82.95936943002155 9.233899980985967),-82.95936943002155,9.233899980985967
2698,5,33,121,159,POINT (-82.95936943002155 9.277763980985966),-82.95936943002155,9.277763980985966
2699,10,36,131,177,POINT (-82.95936943002155 9.321627980985966),-82.95936943002155,9.321627980985966
2700,22,45,130,197,POINT (-82.95936943002155 9.365491980985965),-82.95936943002155,9.365491980985965
2701,31,62,130,223,POINT (-82.95936943002155 9.409355980985964),-82.95936943002155,9.409355980985964
2702,44,68,132,244,POINT (-82.95936943002155 9.453219980985963),-82.95936943002155,9.453219980985963
2703,44,86,132,262,POINT (-82.95936943002155 9.497083980985963),-82.95936943002155,9.497083980985963
2704,48,86,132,266,POINT (-82.95936943002155 9.540947980985962),-82.95936943002155,9.540947980985962
2705,52,85,130,267,POINT (-82.95936943002155 9.584811980985961),-82.95936943002155,9.584811980985961
2706,55,87,131,273,POINT (-82.95936943002155 9.62867598098596),-82.95936943002155,9.62867598098596
2707,60,87,133,280,POINT (-82.95936943002155 9.67253998098596),-82.95936943002155,9.67253998098596
2708,59,87,130,276,POINT (-82.95936943002155 9.716403980985959),-82.95936943002155,9.716403980985959
2709,58,86,127,271,POINT (-82.95936943002155 9.760267980985958),-82.95936943002155,9.760267980985958
2710,55,82,126,263,POINT (-82.95936943002155 9.804131980985957),-82.95936943002155,9.804131980985957
2711,51,82,126,259,POINT (-82.95936943002155 9.847995980985957),-82.95936943002155,9.847995980985957
2712,0,4,29,33,POINT (-82.95936943002155 9.891859980985956),-82.95936943002155,9.891859980985956
2713,0,3,29,32,POINT (-82.95936943002155 9.935723980985955),-82.95936943002155,9.935723980985955
2714,32,63,127,222,POINT (-82.92343743002155 8.400483980985982),-82.92343743002155,8.400483980985982
2715,36,60,128,224,POINT (-82.92343743002155 8.444347980985981),-82.92343743002155,8.444347980985981
2716,36,64,128,228,POINT (-82.92343743002155 8.48821198098598),-82.92343743002155,8.48821198098598
2717,36,66,128,230,POINT (-82.92343743002155 8.53207598098598),-82.92343743002155,8.53207598098598
2718,35,67,129,231,POINT (-82.92343743002155 8.575939980985979),-82.92343743002155,8.575939980985979
2719,37,68,129,234,POINT (-82.92343743002155 8.619803980985978),-82.92343743002155,8.619803980985978
2720,39,72,132,243,POINT (-82.92343743002155 8.663667980985977),-82.92343743002155,8.663667980985977
2721,40,70,137,247,POINT (-82.92343743002155 8.707531980985976),-82.92343743002155,8.707531980985976
2722,43,69,137,249,POINT (-82.92343743002155 8.751395980985976),-82.92343743002155,8.751395980985976
2723,45,64,134,243,POINT (-82.92343743002155 8.795259980985975),-82.92343743002155,8.795259980985975
2724,40,62,131,233,POINT (-82.92343743002155 8.839123980985974),-82.92343743002155,8.839123980985974
2725,35,54,127,216,POINT (-82.92343743002155 8.882987980985973),-82.92343743002155,8.882987980985973
2726,30,43,122,195,POINT (-82.92343743002155 8.926851980985973),-82.92343743002155,8.926851980985973
2727,25,31,123,179,POINT (-82.92343743002155 8.970715980985972),-82.92343743002155,8.970715980985972
2728,21,27,123,171,POINT (-82.92343743002155 9.014579980985971),-82.92343743002155,9.014579980985971
2729,13,21,120,154,POINT (-82.92343743002155 9.05844398098597),-82.92343743002155,9.05844398098597
2730,47,85,130,262,POINT (-82.92343743002155 9.497083980985963),-82.92343743002155,9.497083980985963
2731,50,84,130,264,POINT (-82.92343743002155 9.540947980985962),-82.92343743002155,9.540947980985962
2732,52,86,130,268,POINT (-82.92343743002155 9.584811980985961),-82.92343743002155,9.584811980985961
2733,55,88,133,276,POINT (-82.92343743002155 9.62867598098596),-82.92343743002155,9.62867598098596
2734,61,87,131,279,POINT (-82.92343743002155 9.67253998098596),-82.92343743002155,9.67253998098596
2735,57,86,126,269,POINT (-82.92343743002155 9.716403980985959),-82.92343743002155,9.716403980985959
2736,54,84,125,263,POINT (-82.92343743002155 9.760267980985958),-82.92343743002155,9.760267980985958
2737,52,78,125,255,POINT (-82.92343743002155 9.804131980985957),-82.92343743002155,9.804131980985957
2738,0,4,29,33,POINT (-82.92343743002155 9.847995980985957),-82.92343743002155,9.847995980985957
2739,0,3,29,32,POINT (-82.92343743002155 9.891859980985956),-82.92343743002155,9.891859980985956
2740,36,64,129,229,POINT (-82.88750543002155 8.48821198098598),-82.88750543002155,8.48821198098598
2741,34,65,129,228,POINT (-82.88750543002155 8.53207598098598),-82.88750543002155,8.53207598098598
2742,34,66,129,229,POINT (-82.88750543002155 8.575939980985979),-82.88750543002155,8.575939980985979
2743,35,69,130,234,POINT (-82.88750543002155 8.619803980985978),-82.88750543002155,8.619803980985978
2744,38,68,133,239,POINT (-82.88750543002155 8.663667980985977),-82.88750543002155,8.663667980985977
2745,36,69,136,241,POINT (-82.88750543002155 8.707531980985976),-82.88750543002155,8.707531980985976
2746,37,63,135,235,POINT (-82.88750543002155 8.751395980985976),-82.88750543002155,8.751395980985976
2747,37,59,131,227,POINT (-82.88750543002155 8.795259980985975),-82.88750543002155,8.795259980985975
2748,38,58,128,224,POINT (-82.88750543002155 8.839123980985974),-82.88750543002155,8.839123980985974
2749,35,51,120,206,POINT (-82.88750543002155 8.882987980985973),-82.88750543002155,8.882987980985973
2750,30,38,121,189,POINT (-82.88750543002155 8.926851980985973),-82.88750543002155,8.926851980985973
2751,24,32,122,178,POINT (-82.88750543002155 8.970715980985972),-82.88750543002155,8.970715980985972
2752,22,23,124,169,POINT (-82.88750543002155 9.014579980985971),-82.88750543002155,9.014579980985971
2753,50,83,130,263,POINT (-82.88750543002155 9.497083980985963),-82.88750543002155,9.497083980985963
2754,50,83,129,262,POINT (-82.88750543002155 9.540947980985962),-82.88750543002155,9.540947980985962
2755,50,85,132,267,POINT (-82.88750543002155 9.584811980985961),-82.88750543002155,9.584811980985961
2756,58,88,131,277,POINT (-82.88750543002155 9.62867598098596),-82.88750543002155,9.62867598098596
2757,59,83,126,268,POINT (-82.88750543002155 9.67253998098596),-82.88750543002155,9.67253998098596
2758,55,83,125,263,POINT (-82.88750543002155 9.716403980985959),-82.88750543002155,9.716403980985959
2759,51,80,124,255,POINT (-82.88750543002155 9.760267980985958),-82.88750543002155,9.760267980985958
2760,0,3,29,32,POINT (-82.88750543002155 9.804131980985957),-82.88750543002155,9.804131980985957
2761,0,3,29,32,POINT (-82.88750543002155 9.847995980985957),-82.88750543002155,9.847995980985957
2762,33,67,129,229,POINT (-82.85157343002155 8.575939980985979),-82.85157343002155,8.575939980985979
2763,35,67,131,233,POINT (-82.85157343002155 8.619803980985978),-82.85157343002155,8.619803980985978
2764,32,68,132,232,POINT (-82.85157343002155 8.663667980985977),-82.85157343002155,8.663667980985977
2765,35,64,134,233,POINT (-82.85157343002155 8.707531980985976),-82.85157343002155,8.707531980985976
2766,31,53,128,212,POINT (-82.85157343002155 8.839123980985974),-82.85157343002155,8.839123980985974
2767,36,46,122,204,POINT (-82.85157343002155 8.882987980985973),-82.85157343002155,8.882987980985973
2768,30,36,119,185,POINT (-82.85157343002155 8.926851980985973),-82.85157343002155,8.926851980985973
2769,28,28,123,179,POINT (-82.85157343002155 8.970715980985972),-82.85157343002155,8.970715980985972
2770,16,21,123,160,POINT (-82.85157343002155 9.014579980985971),-82.85157343002155,9.014579980985971
2771,50,82,131,263,POINT (-82.85157343002155 9.497083980985963),-82.85157343002155,9.497083980985963
2772,52,80,132,264,POINT (-82.85157343002155 9.540947980985962),-82.85157343002155,9.540947980985962
2773,53,82,132,267,POINT (-82.85157343002155 9.584811980985961),-82.85157343002155,9.584811980985961
2774,53,84,129,266,POINT (-82.85157343002155 9.62867598098596),-82.85157343002155,9.62867598098596
2775,58,83,125,266,POINT (-82.85157343002155 9.67253998098596),-82.85157343002155,9.67253998098596
2776,52,82,125,259,POINT (-82.85157343002155 9.716403980985959),-82.85157343002155,9.716403980985959
2777,0,4,29,33,POINT (-82.85157343002155 9.760267980985958),-82.85157343002155,9.760267980985958
2778,0,3,29,32,POINT (-82.85157343002155 9.804131980985957),-82.85157343002155,9.804131980985957
2779,31,37,123,191,POINT (-82.81564143002154 8.882987980985973),-82.81564143002154,8.882987980985973
2780,28,31,122,181,POINT (-82.81564143002154 8.926851980985973),-82.81564143002154,8.926851980985973
2781,27,25,123,175,POINT (-82.81564143002154 8.970715980985972),-82.81564143002154,8.970715980985972
2782,53,81,133,267,POINT (-82.81564143002154 9.540947980985962),-82.81564143002154,9.540947980985962
2783,53,80,131,264,POINT (-82.81564143002154 9.584811980985961),-82.81564143002154,9.584811980985961
2784,55,81,127,263,POINT (-82.81564143002154 9.62867598098596),-82.81564143002154,9.62867598098596
2785,52,82,125,259,POINT (-82.81564143002154 9.67253998098596),-82.81564143002154,9.67253998098596
2786,0,6,38,44,POINT (-82.81564143002154 9.716403980985959),-82.81564143002154,9.716403980985959
2787,0,3,29,32,POINT (-82.81564143002154 9.760267980985958),-82.81564143002154,9.760267980985958
2788,0,5,29,34,POINT (-82.81564143002154 9.804131980985957),-82.81564143002154,9.804131980985957
2789,29,34,121,184,POINT (-82.77970943002154 8.882987980985973),-82.77970943002154,8.882987980985973
2790,32,28,122,182,POINT (-82.77970943002154 8.926851980985973),-82.77970943002154,8.926851980985973
2791,53,79,132,264,POINT (-82.77970943002154 9.540947980985962),-82.77970943002154,9.540947980985962
2792,52,79,131,262,POINT (-82.77970943002154 9.584811980985961),-82.77970943002154,9.584811980985961
2793,51,80,126,257,POINT (-82.77970943002154 9.62867598098596),-82.77970943002154,9.62867598098596
2794,1,4,29,34,POINT (-82.77970943002154 9.67253998098596),-82.77970943002154,9.67253998098596
2795,0,3,29,32,POINT (-82.77970943002154 9.716403980985959),-82.77970943002154,9.716403980985959
2796,0,3,29,32,POINT (-82.77970943002154 9.760267980985958),-82.77970943002154,9.760267980985958
2797,31,29,123,183,POINT (-82.74377743002154 8.926851980985973),-82.74377743002154,8.926851980985973
2798,54,79,132,265,POINT (-82.74377743002154 9.540947980985962),-82.74377743002154,9.540947980985962
2799,49,80,128,257,POINT (-82.74377743002154 9.584811980985961),-82.74377743002154,9.584811980985961
2800,47,80,125,252,POINT (-82.74377743002154 9.62867598098596),-82.74377743002154,9.62867598098596
2801,0,3,29,32,POINT (-82.74377743002154 9.67253998098596),-82.74377743002154,9.67253998098596
2802,0,3,29,32,POINT (-82.74377743002154 9.716403980985959),-82.74377743002154,9.716403980985959
2803,51,79,131,261,POINT (-82.70784543002154 9.540947980985962),-82.70784543002154,9.540947980985962
2804,48,80,126,254,POINT (-82.70784543002154 9.584811980985961),-82.70784543002154,9.584811980985961
2805,46,77,125,248,POINT (-82.70784543002154 9.62867598098596),-82.70784543002154,9.62867598098596
2806,0,3,29,32,POINT (-82.70784543002154 9.67253998098596),-82.70784543002154,9.67253998098596
2807,48,78,127,253,POINT (-82.67191343002153 9.540947980985962),-82.67191343002153,9.540947980985962
2808,47,80,125,252,POINT (-82.67191343002153 9.584811980985961),-82.67191343002153,9.584811980985961
2809,46,18,123,187,POINT (-82.67191343002153 9.62867598098596),-82.67191343002153,9.62867598098596
2810,0,5,29,34,POINT (-82.67191343002153 9.67253998098596),-82.67191343002153,9.67253998098596
2811,47,79,124,250,POINT (-82.63598143002153 9.584811980985961),-82.63598143002153,9.584811980985961
2812,46,11,122,179,POINT (-82.63598143002153 9.62867598098596),-82.63598143002153,9.62867598098596
2813,43,77,124,244,POINT (-82.60004943002153 9.584811980985961),-82.60004943002153,9.584811980985961
